Locale=['Locale']
SR=[]
Registry=['Registry']
ExpandString=['ExpandString']
KeyHandler=['KeyHandler']
Win32Native=['ASN1Convert', 'Win32Native', 'ParseNumbers', 'MiscellaneousUtils', 'LexerUtils', '丙上丝且丄丝与丆专']
DataConverter=['DataStorage', '下丐丘丙七三一丁不']
Runtime=['Runtime']
RuntimeMarshal=['RuntimeMarshal']
RuntimeStructs=[]
SmallXmlParser=['SmallXmlParser']
CodePointIndexer=['CodePointIndexer']
TailoringInfo=['TailoringInfo']
Contraction=['Contraction']
Level2Map=['Level2Map']
MSCompatUnicodeTable=['MSCompatUnicodeTable']
MSCompatUnicodeTableUtil=['MSCompatUnicodeTableUtil']
NormalizationTableUtil=['NormalizationTableUtil']
SimpleCollator=['SimpleCollator']
SortKeyBuffer=['SortKeyBuffer']
ASN1=['ASN1']
ASN1Convert=['ASN1Convert', 'DescriptorHelpers']
BitConverterLE=['BitConverterLE', 'BitConverterLE']
PKCS7=[]
SafeBag=[]
X501=['X501']
X509Chain=['SmallXmlParser']
X509Extension=['X509Extension', 'XmlTypeMapMember', 'NamespaceList', '丘丝丗丆丄东丌业世']
X509Store=[]
X509StoreManager=['丄丂丂丘上丌丄不且', '丁上丗三丐丄业丞一', '丟丁丑业丈业丁丐不', '下专且专丂七丂七下', '丂丕东丝丑业上与专', '丞丅丗与丟世不专一', '一与一丅丛丒七下丛']
X509Stores=[]
CryptoConvert=['CryptoConvert']
KeyBuilder=['KeyBuilder']
BlockProcessor=['SmallXmlParser', 'ASN1', 'MonoChunkStream', 'DebuggerAction', 'WatchItem']
KeyPairPersistence=['KeyPairPersistence']
PKCS1=['PKCS1']
PKCS8=['SharedStatics']
HMACAlgorithm=['KeyPairPersistence', 'ManifestBuilder', 'ValidatingReaderNodeData', 'XmlTypeMapElementInfo', 'XmlTypeMapMember', 'NamespaceList', 'LuaState', 'WatchItem', 'HTTPFieldData']
MACAlgorithm=[]
AuthenticodeBase=['SortKeyBuffer', '上东丙丕万丝丗丗不']
BigInteger=['BigInteger']
PrimalityTests=['PrimalityTests']
PrimeGeneratorBase=['PrimeGeneratorBase']
ThrowHelper=['ThrowHelper']
Tuple=['Tuple']
AppContextSwitches=['AppContextSwitches']
LazyHelpers=['LazyHelpers']
__Filters=['__Filters']
LocalDataStoreHolder=['LocalDataStoreHolder']
LocalDataStoreElement=['LocalDataStoreElement']
LocalDataStore=['LocalDataStore']
LocalDataStoreSlot=['LocalDataStoreSlot']
LocalDataStoreMgr=['LocalDataStoreMgr']
BitConverter=['BitConverter']
Buffer=['Buffer']
Convert=['Convert']
EventArgs=['EventArgs']
GC=['GC']
DateTimeFormat=['DateTimeFormat']
DateTimeParse=['DateTimeParse']
Math=['Math']
Number=['Number']
Random=['Random']
SharedStatics=['SharedStatics']
CLRConfig=['CLRConfig']
CompatibilitySwitches=[]
Environment=['Environment']
ParseNumbers=['ParseNumbers']
MonoTypeInfo=['MonoTypeInfo']
TypeNameParser=['TypeNameParser']
Console=['Console']
ConsoleDriver=['ConsoleDriver']
DelegateData=['DelegateData']
KnownTerminals=['KnownTerminals']
MarshalByRefObject=['MarshalByRefObject']
MonoAsyncCall=['MonoAsyncCall']
MonoCustomAttrs=['MonoCustomAttrs']
MonoListItem=['MonoListItem']
Nullable=[]
NumberFormatter=['NumberFormatter']
Object=['Object']
ParameterizedStrings=['ParameterizedStrings']
ByteMatcher=['ByteMatcher']
TermInfoReader=['TermInfoReader']
TimeZone=['DecoderFallback', 'EncoderFallback']
TimeType=['TimeType']
TypeNames=[]
TypeIdentifiers=['TypeIdentifiers']
TypeSpec=['TypeSpec']
ValueType=['ValueType']
__ComObject=['__ComObject']
Decoder=['Decoder']
DecoderFallback=[]
DecoderFallbackBuffer=['DecoderFallbackBuffer']
Encoder=['Encoder']
EncoderFallback=[]
EncoderFallbackBuffer=['EncoderFallbackBuffer']
EncodingProvider=['EncodingProvider']
StringBuilderCache=['StringBuilderCache']
Normalization=['Normalization']
EncodingHelper=['EncodingHelper']
ResourceManager=['ResourceManager']
CustomAttributeExtensions=[]
Binder=['Binder']
IntrospectionExtensions=[]
ManifestResourceInfo=['ManifestResourceInfo']
CustomAttributeData=['CustomAttributeData']
ExceptionHandlingClause=['ExceptionHandlingClause']
LocalVariableInfo=['LocalVariableInfo']
MethodBody=['MethodBody']
__Error=['__Error']
Directory=['Directory']
FileSystemEnumerableFactory=[]
SearchResult=['SearchResult']
FileSystemEnumerableHelpers=[]
PathInternal=['PathInternal']
File=['File']
MonoIO=['MonoIO']
Path=['Path']
CharUnicodeInfo=['CharUnicodeInfo']
CalendarData=['CalendarData']
TokenHashValue=['TokenHashValue']
DateTimeFormatInfoScanner=['DateTimeFormatInfoScanner']
EraInfo=['EraInfo']
GregorianCalendarHelper=['GregorianCalendarHelper']
HebrewNumber=['HebrewNumber']
TimeSpanFormat=['TimeSpanFormat']
TimeSpanParse=['TimeSpanParse']
SortKey=['SortKey']
CultureData=['CultureData']
CodePageDataItem=['CodePageDataItem']
EncodingTable=['EncodingTable']
TextInfoToUpperData=['TextInfoToUpperData']
TextInfoToLowerData=['TextInfoToLowerData']
IdnMapping=['IdnMapping']
Bootstring=['Bootstring']
RegionInfo=['RegionInfo']
Debugger=['Debugger']
StackFrame=['StackFrame']
StackTrace=['StackTrace']
Contract=['Contract']
HashHelpers=[]
AtomicBoolean=['AtomicBoolean']
CancellationCallbackInfo=['CancellationCallbackInfo']
LazyInitializer=['LazyInitializer']
PlatformHelper=['PlatformHelper']
TimeoutHelper=['TimeoutHelper']
Monitor=['Monitor']
SynchronizationContext=['SynchronizationContext']
ThreadHelper=['ThreadHelper']
ThreadPoolGlobals=['ThreadPoolGlobals']
ThreadPoolWorkQueue=['ThreadPoolWorkQueue']
ThreadPoolWorkQueueThreadLocals=['ThreadPoolWorkQueueThreadLocals']
_ThreadPoolWaitCallback=[]
ThreadPool=['ThreadPool']
Timeout=['Timeout']
Interlocked=['Interlocked']
LockQueue=['LockQueue']
NativeEventCalls=['NativeEventCalls']
Volatile=[]
AsyncCausalityTracer=['AsyncCausalityTracer']
SystemThreadingTasks_TaskDebugView=[]
StackGuard=['StackGuard']
TaskContinuation=['TaskContinuation']
TaskExceptionHolder=['TaskExceptionHolder']
TaskFactory=['TaskFactory', 'SimpleJson', '丘下万丑专丞专丅下']
TaskScheduler=['TaskScheduler']
TaskToApm=['TaskToApm']
SecurityDocument=['SecurityDocument', 'InterpretedFrame']
HostSecurityManager=['GlvTypeBParameters']
PermissionBuilder=[]
SecurityElement=['SecurityElement']
SecurityManager=['HTTPManager']
SecurityState=[]
ApplicationSecurityManager=[]
EvidenceBase=[]
PolicyLevel=['LocalDataStoreSlot', 'SerializationObjectManager', 'UnmanagedMarshal', 'AsyncOperation', 'InstanceDescriptor', 'Oid', 'PublicKey', 'X509ChainPolicy', 'HttpListenerContext', 'ConfigurationSettings', 'GUILayoutOption', 'DataRowBuilder', '丝丟丕上丙东上一丗', 'Message', 'HeartbeatManager']
TrustManagerContext=[]
StrongNamePublicKeyBlob=['IdnMapping', 'XNamespace', 'DateTimeObject', 'ProtocolVersion']
GenericAce=['GenericAce']
GenericSecurityDescriptor=[]
ObjectSecurity=['ObjectSecurity']
Parser=['Parser']
Tokenizer=['Tokenizer']
TokenizerShortBlock=['TokenizerShortBlock']
TokenizerStringBlock=['TokenizerStringBlock']
TokenizerStream=['TokenizerStream']
IdentityReference=['IdentityReference']
Claim=['Claim']
AsymmetricKeyExchangeDeformatter=['AsymmetricKeyExchangeDeformatter']
AsymmetricKeyExchangeFormatter=['AsymmetricKeyExchangeFormatter']
AsymmetricSignatureDeformatter=['AsymmetricSignatureDeformatter']
AsymmetricSignatureFormatter=['AsymmetricSignatureFormatter']
KeySizes=['KeySizes']
CspParameters=['CspParameters']
MaskGenerationMethod=['MaskGenerationMethod']
SignatureDescription=['SignatureDescription']
Constants=[]
Utils=['Utils']
CryptoConfig=['CryptoConfig']
CspKeyContainerInfo=['CspKeyContainerInfo']
SHA1Internal=['SHA1Internal']
X509Constants=[]
X509Helper=['X509Helper']
BinaryCompatibility=[]
FormatterServices=['FormatterServices']
MemberHolder=['MemberHolder']
ObjectIDGenerator=['ObjectIDGenerator']
ObjectManager=['ObjectManager']
ObjectHolder=['ObjectHolder']
FixupHolder=['FixupHolder']
FixupHolderList=['FixupHolderList']
LongList=['LongList']
ObjectHolderList=['ObjectHolderList']
ObjectHolderListEnumerator=['ObjectHolderListEnumerator']
TypeLoadExceptionHolder=['TypeLoadExceptionHolder']
SerializationBinder=['SerializationBinder']
SerializationEvents=['SerializationEvents']
SerializationEventsCache=[]
SerializationInfo=['SerializationInfo']
SerializationObjectManager=['SerializationObjectManager']
ValueTypeFixupInfo=['ValueTypeFixupInfo']
BinaryConverter=['BinaryConverter']
IOUtil=['IOUtil']
BinaryAssemblyInfo=['BinaryAssemblyInfo']
BinaryMethodCall=['BinaryMethodCall']
ObjectMap=['ObjectMap']
ObjectProgress=['ObjectProgress']
Converter=['Converter']
__BinaryWriter=['__BinaryWriter']
ObjectMapInfo=['ObjectMapInfo']
WriteObjectInfo=['WriteObjectInfo']
ReadObjectInfo=['ReadObjectInfo']
SerObjectInfoInit=['SerObjectInfoInit']
SerObjectInfoCache=['SerObjectInfoCache']
TypeInformation=['TypeInformation']
ObjectReader=['ObjectReader']
ObjectWriter=['ObjectWriter']
__BinaryParser=['__BinaryParser']
ParseRecord=['ParseRecord']
SerStack=['SerStack']
NameCache=['NameCache']
ValueFixup=['ValueFixup']
InternalFE=[]
NameInfo=['NameInfo']
PrimitiveArray=['PrimitiveArray']
Identity=['Identity']
InternalRemotingServices=['InternalRemotingServices']
RemotingConfiguration=['RemotingConfiguration']
ChannelData=['ChannelData']
ProviderData=['ProviderData']
RemotingServices=['RemotingServices']
SoapServices=['SoapServices']
TypeEntry=['TypeEntry']
TrackingServices=['TrackingServices']
TransparentProxy=['TransparentProxy']
RealProxy=['RealProxy']
LeaseManager=['LeaseManager']
LifetimeServices=['LifetimeServices']
Context=['Context']
DynamicPropertyCollection=['DynamicPropertyCollection']
ChannelServices=['ChannelServices']
CrossAppDomainData=['CrossAppDomainData']
CADSerializer=['CADSerializer']
AsyncRequest=[]
SinkProviderData=['SinkProviderData']
ActivationServices=['ActivationServices']
CallContext=['CallContext']
IllogicalCallContext=['IllogicalCallContext']
ArgInfo=['ArgInfo']
CADArgHolder=['CADArgHolder']
CADObjRef=['CADObjRef']
CADMethodRef=['CADMethodRef']
CADMessageBase=['CADMessageBase']
Header=['Header']
ExceptionDispatchInfo=['ExceptionDispatchInfo']
CriticalFinalizerObject=['CriticalFinalizerObject']
AsyncTaskCache=['AsyncTaskCache']
FormattableStringFactory=[]
IsVolatile=[]
JitHelpers=['JitHelpers']
RuntimeHelpers=['RuntimeHelpers']
ErrorWrapper=['ErrorWrapper']
Marshal=['Marshal']
HashHelpers=['HashHelpers']
CollectionExtensions=['CollectionExtensions']
KeyValuePair=['KeyValuePair']
IntrospectiveSortUtilities=[]
DictionaryHashHelpers=['DictionaryHashHelpers']
UnmanagedMarshal=['UnmanagedMarshal']
__Il2CppComObject=['__Il2CppComObject']
Locale=['Locale']
ASN1=['ASN1']
ASN1Convert=['Dns', 'ASN1Convert', '万丟世丙丁业丅丛与']
BitConverterLE=['BitConverterLE']
PKCS7=[]
PKCS5=[]
PKCS9=[]
SafeBag=[]
X501=['X501']
X509Builder=['丟下且下丁一丘专丘']
X509Crl=['TurnBasedMatch']
X509Chain=[]
X509Extension=['丘丝丗丆丄东丌业世']
X509Store=['XmlSchemaSet', 'EventDelegate', 'LobbyItemsBundle']
X509StoreManager=['CachedReflectionInfo']
X509Stores=['XmlAttributes']
X520=[]
GeneralNames=['SmallXmlParser', 'TailCallData']
Alert=[]
CipherSuite=['PhotonPeer']
CipherSuiteFactory=[]
ClientSessionCache=['丏丒丟与且丕业丘丄']
Context=['JsonProperty']
DebugHelper=[]
RecordProtocol=['Identity', 'XmlReaderSettings', 'Event']
SecurityParameters=['ASN1']
TlsClientSettings=['XPathNodeInfoAtom']
TlsServerSettings=['ScriptOptions']
ChallengeResponse2=['ChallengeResponse2']
MessageBase=['MessageBase']
NtlmSettings=['NtlmSettings']
Alert=['Alert']
ValidationResult=['ValidationResult', 'TimeKeeper']
CertificateValidationHelper=['CertificateValidationHelper']
MonoTlsConnectionInfo=['LeaderboardScoreData']
MonoTlsProvider=['MonoTlsProvider']
MonoTlsProviderFactory=[]
MonoTlsSettings=['MonoTlsSettings']
CryptoConvert=['CryptoConvert']
KeyBuilder=['KeyBuilder']
PKCS1=['PKCS1']
PKCS8=[]
PrivateKey=['PrivateKey']
BigInteger=['BigInteger']
PrimalityTests=['PrimalityTests']
PrimeGeneratorBase=['PrimeGeneratorBase']
SR=[]
CertHelper=['CertHelper']
Debug=[]
UnityTls=['UnityTls']
UnityTlsConversions=['UnityTlsConversions']
CFProxy=['CFProxy']
CFProxySettings=['CFProxySettings']
CFNetwork=['CFNetwork']
BufferOffsetSize=['BufferOffsetSize']
AsyncProtocolResult=['AsyncProtocolResult']
AsyncProtocolRequest=['AsyncProtocolRequest']
MonoTlsProviderFactory=['MonoTlsProviderFactory']
MonoTlsStream=['MonoTlsStream']
NoReflectionHelper=['NoReflectionHelper']
SystemCertificateValidator=['SystemCertificateValidator']
CallbackHelpers=[]
NtlmSession=['NtlmSession']
NativeMethods=['NativeMethods', 'TypeExtensions']
StringExtensions=[]
UriBuilder=['UriBuilder', 'Cookie', 'GooglePurchase', 'Achievement']
SecurityUtils=['RemotingServices', 'SecurityUtils']
HResults=[]
IriHelper=['IriHelper']
UriHelper=['UriHelper']
UriParser=['UriParser']
DomainNameHelper=['DomainNameHelper']
IPv4AddressHelper=['IPv4AddressHelper']
IPv6AddressHelper=['IPv6AddressHelper']
UncNameHelper=['HebrewNumber', 'DomainNameHelper', 'UncNameHelper', 'FormatProvider', 'XMLSchema', 'ArabicFixerTool', '丄丈丄丁业专丂业丙', '丁丟丂丒丄万丛丗丈', '上丅丘且专上万与丂', '东丒丏万丛丒专三东']
EnvironmentHelpers=[]
LocalAppContextSwitches=['LocalAppContextSwitches']
IOSelector=[]
Platform=['Platform', 'PlatformAutoDetector']
CachedCodeEntry=['CachedCodeEntry']
ExclusiveReference=['ExclusiveReference']
SharedReference=['SharedReference']
RegexBoyerMoore=['RegexBoyerMoore']
Capture=['Capture']
RegexCharClass=['RegexCharClass']
RegexCode=['RegexCode']
RegexFCD=['RegexFCD']
RegexFC=['RegexFC']
RegexPrefix=['RegexPrefix']
RegexNode=['RegexNode']
RegexParser=['RegexParser']
RegexReplacement=['RegexReplacement']
RegexRunner=['RegexRunner']
RegexRunnerFactory=['RegexRunnerFactory']
RegexTree=['RegexTree']
RegexWriter=['RegexWriter']
CorrelationManager=['XmlAttributeOverrides']
Debug=[]
Switch=['Switch']
Trace=['LifetimeServices', 'LicenseManager']
TraceEventCache=['ClanItem', '丗业专业上丌万与专']
TraceFilter=[]
TraceInternal=['TraceInternal']
ProcessInfo=[]
ProcessStartInfo=['ProcessStartInfo']
Stopwatch=['Stopwatch']
AsyncOperation=['AsyncOperation']
AsyncOperationManager=['AsyncOperationManager']
ComponentEditor=['ComponentEditor']
CompModSwitches=['CompModSwitches']
ContainerFilterService=[]
InstanceCreationEditor=['InstanceCreationEditor']
IntSecurity=[]
LicenseManager=['LicenseManager']
LicenseProvider=[]
ListSortDescription=['ListSortDescription']
MemberDescriptor=['MemberDescriptor']
SyntaxCheck=['SyntaxCheck']
TypeConverter=['TypeConverter']
TypeDescriptionProvider=['TypeDescriptionProvider']
TypeDescriptor=['TypeDescriptor']
DesigntimeLicenseContextSerializer=['DesigntimeLicenseContextSerializer']
InstanceDescriptor=['InstanceDescriptor']
HandleCollector=['BMFont', '专丁下万世万且丞丐', '丒丐专丞丄丐丈丂丂']
TokenBinding=[]
Oid=['HeaderValue']
CAPI=[]
AsnEncodedData=['AsnEncodedData']
X509Utils=[]
OSX509Certificates=['CFNetwork']
PublicKey=['PublicKey']
X509ChainElement=['XmlReflectionMember', 'LeaderboardScoreData']
X509ChainPolicy=['MonoTlsSettings']
X509Helper2=['TypeDescriptorRegistry']
DeflateStreamNative=['DeflateStreamNative']
HttpStatusDescription=[]
SecurityProtocol=[]
UriScheme=[]
Authorization=['PlatformSettings']
CredentialHostKey=['CredentialKey']
CredentialKey=['CredentialKey']
EndPoint=['EndPoint']
GlobalProxySelection=['GraphicRegistry', 'MaskUtilities', 'ClipperRegistry', '不东且丙世万丟东丞', '丟一丕丑丟丈丝一丈', 'ECNamedCurveTable', 'TeleTrusTNamedCurves', 'AnssiNamedCurves']
HttpListenerRequestUriBuilder=['HttpListenerRequestUriBuilder']
HttpVersion=['丕东业丘专世七万不']
IPAddress=['IPAddress']
IPHostEntry=['IPHostEntry']
IntPtrHelper=[]
NclUtilities=['丕丙丝世下东且与万']
NclConstants=[]
ValidationHelper=['ValidationHelper']
ExceptionHelper=['世丈丂丗丄世丗丛上']
SecurityBuffer=['WebConnectionData']
SecurityBufferDescriptor=['TailoringInfo']
SecChannelBindings=['FreePlayTaskConfig']
WebRequestPrefixElement=['WebRequestPrefixElement']
HttpKnownHeaderNames=[]
KnownHttpVerb=['世丂丌世丛且丗丑丒']
HttpProtocolUtils=[]
SplitWritesState=['ObjectHolderListEnumerator', 'SerializationEvents', '丌丝丞下丕与丟东下', '丁业丛丞丂与丅丗上']
SocketAddress=['SocketAddress']
TransportContext=[]
WebExceptionMapping=['WebExceptionMapping']
HostHeaderString=['丅丏丌丏丐且丒专业']
DelayedRegex=[]
WebRequestMethods=[]
WebUtility=['丑丛丑下且丂丘丛世']
BufferOffsetSize=[]
HttpDateParse=['RuntimeMarshal', 'ReflectionExtensions', 'SpanHelpers', 'PathInternal', 'NativeEventCalls', 'UnityTls', 'NativeMethods', 'Platform', 'X509Helper2', 'BinHexEncoder', 'Ref', 'JavaScriptUtils', 'MathUtils', 'MiscellaneousUtils', 'StringReferenceExtensions', 'StringUtils', 'ParserHelpers', 'MessagePackCompressionExtensions', 'ReflectionExtensions', 'LuaTypeExtensions', 'CoreModules_ExtensionMethods', 'ScriptToClrConversions', 'MemberDescriptor', 'HTTPProtocolFactory', '丝丛丕丑丙丄一世丟']
HeaderInfo=['HeaderInfo']
HeaderInfoTable=['HeaderInfoTable']
BaseLoggingObject=['RecordStream']
GlobalLog=['GUI', 'TJPlacement']
NetRes=['AssertionMessageUtil']
ScatterGatherBuffers=['上东丙丕万丝丗丗不', '与丛不三丞丝世下丛', '丘丄丆万丄丄丅丒业']
ServiceNameStore=['NamespaceList']
TimerThread=['世世三且三不东丝丄']
WebProxyDataBuilder=['JsonSerializerInternalBase', 'BsonToken', '丌丂三丁丐丞丆丅万', '丈丟丟丘丟丂丟丏丗', '上丝丝一上丝万业业', '万丁丂丆七丙丈丆下']
ConnectionPool=['丆且丑丌世万丆丒丈']
InterlockedStack=[]
Cookie=['Cookie']
CookieTokenizer=['CookieTokenizer']
CookieParser=[]
CookieContainer=['专丁下万世万且丞丐']
PathList=['PathList']
WebProxyData=['七丒丒丅下丘且丈万']
AutoWebProxyScriptEngine=['ScriptLoadingContext']
UnsafeNclNativeMethods=[]
HttpSysSettings=[]
Logging=['世丈丂丗丄世丗丛上']
TraceSource=[]
ServerCertValidationCallback=['ServerCertValidationCallback']
AuthenticationManager=['Application', 'SceneManager', 'GUI']
DigestHeaderParser=['DigestHeaderParser']
DigestSession=['DigestSession']
Dns=['丕丝丈丟三世丈丐上']
EndPointListener=['EndPointListener']
EndPointManager=['EndPointManager']
EndpointPermission=['ServicePoint', '丗业专业上丌万与专']
FtpStatus=['FtpStatus']
HttpConnection=['HttpConnection']
HttpListenerContext=['HttpListenerContext']
HttpListenerRequest=['JsonProperty', 'PhotonPeer']
HttpListenerTimeoutManager=['GameEventItemContainer']
ListenerPrefix=['ListenerPrefix']
MonoChunkStream=['MonoChunkStream']
MonoHttpDate=['业丂且丆下丞丛丁丙']
ServicePoint=['ServicePoint']
ServicePointManager=['GUI', 'HTTPManager']
WebConnection=['WebConnection']
WebConnectionData=['WebConnectionData']
WebConnectionGroup=['WebConnectionGroup']
EncodedStreamFactory=['SceneManagerCompat']
WriteStateInfoBase=['丅丑丟丏下丝丁丕丘', '丒丙丄丛丙东丞专丐', '与丛不三丞丝世下丛', '丘丏丁丗丆丂丙丅丞']
LingerOption=[]
MulticastOption=['ClanItem']
IPv6MulticastOption=['Stopwatch']
SendPacketsElement=['BMFont', '专丁下万世万且丞丐', 'Achievement']
TcpListener=[]
MultipleConnectAsync=['丟下专一丒丁三下丆']
SocketTaskExtensions=['Console']
GatewayIPAddressInformation=[]
IPAddressInformation=['MonoTlsProvider']
IPGlobalProperties=['ECFieldElement']
IPGlobalStatistics=['ECFieldElement']
IPInterfaceProperties=[]
IPInterfaceStatistics=['XPathItem']
IPv4InterfaceStatistics=['XPathItem']
IPv4InterfaceProperties=['ECFieldElement']
IPv6InterfaceProperties=['ECFieldElement']
IcmpV4Statistics=['Decoder', 'DecoderFallback', 'Encoder', 'EncoderFallback', 'EncoderFallbackBuffer', 'TaskScheduler', 'RealProxy', 'UriParser', 'RegexRunner', 'MemberDescriptor', 'TypeDescriptionProvider', 'SettingsBase', 'MessageBase', 'XPathItem', 'XmlSchemaDatatype', 'XmlSchemaObject', 'XmlValueConverter', 'ExpressionVisitor', 'CallSiteBinder', 'Constraint', 'GenericDecalProjectorBase', 'JsonContract', 'NamingStrategy', 'ApiBinding', 'Language', 'ABSTweenPlugin', 'ABSTweenComponentParms', 'IProtocol', 'IPhotonSocket', '丞丙万丛丏世专丁丏', '丟下且下丁一丘专丘', '丆专丒丆丘业不万业', 'Arrays', 'ECCurve', 'ECFieldElement', 'ECPoint', 'WNafUtilities', 'PbeParametersGenerator', 'TlsDHUtilities', 'TlsEccUtilities', 'TlsExtensionsUtilities', 'X9ObjectIdentifiers', 'X509ObjectIdentifiers', 'SecObjectIdentifiers', 'OiwObjectIdentifiers', 'MiscObjectIdentifiers', 'CryptoProObjectIdentifiers']
IcmpV6Statistics=['XmlValueConverter', 'ExpressionVisitor', 'ApiBinding', 'ABSTweenPlugin', 'Arrays', 'ECCurve', 'ECPoint', 'X9ObjectIdentifiers']
NetworkInterface=[]
PhysicalAddress=['IPAddress']
PingOptions=['TimeKeeper']
PingReply=['LeaderboardScoreData', 'TurnBasedMatch']
TcpConnectionInformation=['SettingsBase']
TcpStatistics=['XPathItem']
UdpStatistics=['XPathItem']
Win32_IP_PER_ADAPTER_INFO=[]
IcmpV6MessageTypes=[]
NetworkChange=['FirebaseAnalytics', '丌东丌丘丌丝丌丄丄']
SystemNetworkInterface=['TraceInternal']
NetworkInterfaceFactory=['PrimeGeneratorBase']
Win32NetworkInterface=['Win32NetworkInterface']
DefaultProxySectionInternal=['DefaultProxySectionInternal']
SettingsSectionInternal=['SettingsSectionInternal']
RequestCache=['RequestCache']
RequestCacheManager=['AudioExtensionManager']
RequestCacheValidator=['RequestCacheValidator']
RequestCachingSectionInternal=['TailoringInfo', 'TimeType', 'EnumInfo']
RequestCacheBinding=['BuildTimeScopeBlock', '丟万丘专丟专丄丗丞', 'StorePromotionConfig', '且三上丛丛三丟丙且']
RequestCachePolicy=['Alert', 'MonoTlsConnectionInfo', 'MatchOutcome']
RequestCacheProtocol=[]
WebSocketContext=[]
SettingsBase=['SettingsBase']
SettingsProperty=['SettingsProperty']
SettingsPropertyValue=['SettingsPropertyValue']
StringNormalizationExtensions=['丑丞丘丒业丈不专丒', '丈丘丕丐丅丂丂丘不', 'EventNames']
AppSettingsReader=['AppSettingsReader']
ConfigurationSettings=['ConfigurationSettings']
ConfigurationElement=['ConfigurationElement']
Configuration=[]
ConfigurationSectionGroup=[]
ProviderBase=['ProviderBase']
SR=[]
AstNode=['AstNode']
XPathParser=['XPathParser']
XPathScanner=['XPathScanner']
XPathNodeHelper=['XPathNodeHelper']
XPathNodePageInfo=['XPathNodePageInfo']
XPathNodeInfoAtom=['XPathNodeInfoAtom']
LocalAppContextSwitches=[]
AsyncHelper=['AsyncHelper']
Base64Encoder=['Base64Encoder']
BinHexEncoder=['BinHexEncoder']
BitStack=['BitStack']
Bits=['Bits']
ByteStack=['ByteStack']
BinaryCompatibility=['BinaryCompatibility']
HtmlTernaryTree=['HtmlTernaryTree']
IncrementalReadDecoder=['IncrementalReadDecoder']
ReadContentAsBinaryHelper=['ReadContentAsBinaryHelper']
TernaryTreeReadOnly=['TernaryTreeReadOnly']
ValidatingReaderNodeData=['ValidatingReaderNodeData']
XmlParserContext=['XmlParserContext']
XmlReaderSettings=['XmlReaderSettings']
XmlWriterSettings=['XmlWriterSettings']
AttributePSVIInfo=['AttributePSVIInfo']
DomNameTable=['DomNameTable']
XmlImplementation=['XmlImplementation']
XmlLoader=['XmlLoader']
Ref=[]
ValidateNames=['ValidateNames', '三丘万且丐万三三丝']
XmlComplianceUtil=[]
XmlConvert=['XmlConvert']
XmlDownloadManager=['XmlDownloadManager']
OpenedHost=[]
XmlNameTable=['XmlNameTable']
XmlQualifiedName=['XmlQualifiedName']
XmlResolver=['XmlResolver']
Res=[]
XPathItem=['XPathItem']
XmlSerializerNamespaces=['XmlSerializerNamespaces']
AxisElement=['AxisElement']
AxisStack=['AxisStack']
ActiveAxis=['ActiveAxis']
ForwardAxis=['ForwardAxis']
Asttree=['Asttree']
BaseProcessor=['BaseProcessor']
BaseValidator=['BaseValidator']
BitSet=['BitSet']
ChameleonKey=['ChameleonKey']
CompiledIdentityConstraint=['CompiledIdentityConstraint']
ConstraintStruct=['ConstraintStruct']
KSStruct=[]
TypedObject=['TypedObject']
KeySequence=['KeySequence']
SymbolsDictionary=['SymbolsDictionary']
Positions=['Positions']
SyntaxTreeNode=['SyntaxTreeNode']
ContentValidator=['ContentValidator']
XsdSimpleValue=['XsdSimpleValue']
RestrictionFacets=['RestrictionFacets']
FacetsChecker=['FacetsChecker']
NamespaceList=['NamespaceList']
Parser=['Parser']
RedefineEntry=[]
SchemaBuilder=['SchemaBuilder']
SchemaDeclBase=['SchemaDeclBase']
SchemaNames=['SchemaNames']
SchemaNotation=['SchemaNotation']
ValidationState=['ValidationState']
XmlSchemaCollectionNode=['XmlSchemaCollectionNode']
XmlSchemaCompilationSettings=['XmlSchemaCompilationSettings']
XmlSchemaDatatype=['XmlSchemaDatatype']
XmlSchemaObject=['XmlSchemaObject']
XmlSchemaObjectTable=['XmlSchemaObjectTable']
XmlSchemaSet=['XmlSchemaSet']
IdRefNode=['IdRefNode']
XmlSchemaValidator=['XmlSchemaValidator']
XmlValueConverter=['XmlValueConverter']
XmlReaderSection=['XmlReaderSection']
SR=[]
TaskExtensions=['TaskExtension']
BCryptNative=[]
CngKeyCreationParameters=['MonoTlsSettings']
CngUIPolicy=['ProcessStartInfo', '丌专丐丘丏丘世丙丕', 'Packet', 'HTTPFieldData']
Error=['Error']
Enumerable=['Enumerable']
BitHelper=['BitHelper']
ManifestSignatureInformation=['PublicKey', 'CatchBlock']
AuthenticodeSignatureInformation=[]
StrongNameSignatureInformation=['CspKeyContainerInfo']
UnityString=[]
AndroidJNIHelper=['AndroidJNIHelper']
AndroidJNI=['AndroidJNI']
AndroidJNISafe=['AndroidJNISafe']
GlobalJavaObjectRef=['GlobalJavaObjectRef']
AndroidJavaProxy=['AndroidJavaProxy']
AndroidReflection=['AndroidReflection']
_AndroidJNIHelper=['_AndroidJNIHelper']
Application=['Application']
AttributeHelperEngine=['AttributeHelperEngine']
BeforeRenderHelper=['BeforeRenderHelper']
BootConfigData=['BootConfigData']
ClassLibraryInitializer=['ClassLibraryInitializer']
SetupCoroutine=['SetupCoroutine']
Cursor=['Cursor']
Debug=['Debug']
Display=['Display']
RectOffset=['RectOffset']
Gizmos=['Gizmos']
Screen=['Application', 'Screen']
Graphics=['SceneManager']
GL=['GL']
LightmapData=['LightmapData']
GraphicsFormatUtility=['GraphicsFormatUtility']
TouchScreenKeyboard=['TouchScreenKeyboard']
Input=['Input']
ManagedStreamHelpers=['ManagedStreamHelpers']
ScriptingUtils=['ScriptingUtils']
SendMouseEvents=['SendMouseEvents']
NoAllocHelpers=['NoAllocHelpers']
PlayerPrefs=['PlayerPrefs']
PropertyNameUtils=['PropertyNameUtils']
Random=['Random']
Resources=['Extensions']
StackTraceUtility=['StackTraceUtility']
SystemClock=['SystemClock']
SystemInfo=['SystemInfo']
Time=['Time']
TrackedReference=['TrackedReference']
UnhandledExceptionHandler=['UnhandledExceptionHandler']
Object=['Object']
BaseInvokableCall=['BaseInvokableCall']
PersistentCall=['PersistentCall']
PersistentCallGroup=['PersistentCallGroup']
InvokableCallList=['InvokableCallList']
YieldInstruction=[]
Assert=['Assert']
AssertionMessageUtil=['AssertionMessageUtil']
ScriptableRuntimeReflectionSystemSettings=['ScriptableRuntimeReflectionSystemSettings']
ScriptableRuntimeReflectionSystemWrapper=['ScriptableRuntimeReflectionSystemWrapper']
MessageEventArgs=['MessageEventArgs']
PlayerEditorConnectionEvents=['PlayerEditorConnectionEvents']
RenderPipelineManager=['RenderPipelineManager']
SupportedRenderingFeatures=['SupportedRenderingFeatures']
SceneManager=['SceneManager']
NetFxCoreExtensions=['NetFxCoreExtensions']
MetaData=[]
MemoryProfiler=['MemoryProfiler']
DataUtility=['DataUtility']
SpriteAtlasManager=['SpriteAtlasManager']
AudioExtensionDefinition=['AudioExtensionDefinition']
AudioSpatializerExtensionDefinition=[]
AudioAmbisonicExtensionDefinition=[]
AudioExtensionManager=['AudioExtensionManager']
AudioSettings=['AudioSettings']
ImageConversion=['ImageConversion']
ControllerColliderHit=['ControllerColliderHit', 'Collision']
Collision=['Collision']
Physics=['Physics']
WWWForm=['WWWForm']
WWWTranscoder=['WWWTranscoder']
WebRequestUtils=['WebRequestUtils']
NavMesh=['NavMesh']
NavMeshPath=['NavMeshPath']
AnimatorControllerParameter=['AnimatorControllerParameter']
AnimationEvent=['AnimationEvent']
Social=['Social']
ActivePlatform=['ActivePlatform']
Event=['Event']
GUI=['GUI']
GUIClip=['GUIClip']
GUIContent=['GUIContent']
GUILayout=['GUILayout']
GUILayoutOption=['GUILayoutOption']
GUILayoutUtility=['GUILayoutUtility']
GUISettings=['GUISettings']
GUIStateObjects=['GUIStateObjects']
GUIStyleState=['GUIStyleState']
GUIStyle=['GUIStyle']
GUIUtility=['GUIUtility']
GUILayoutEntry=['GUILayoutEntry']
ScrollViewState=['ScrollViewState']
SliderState=['SliderState']
TextEditor=['TextEditor']
JsonUtility=['JsonUtility']
Physics2D=['Physics2D']
Collision2D=['Collision2D']
TerrainUtility=['TerrainUtility']
UISystemProfilerApi=['UISystemProfilerApi']
RectTransformUtility=['RectTransformUtility']
UnityWebRequestTexture=[]
FirebaseEditorDispatcher=['FirebaseEditorDispatcher']
FirebaseHandler=['FirebaseHandler']
FirebaseLogger=[]
PlatformInformation=['PlatformInformation']
UnityPlatformServices=['UnityPlatformServices']
Services=['世世三且三不东丝丄']
Dispatcher=['Dispatcher']
XNamespace=['XNamespace']
BaseUriAnnotation=[]
LineInfoAnnotation=[]
XObjectChangeAnnotation=[]
XDeclaration=['XDeclaration']
XStreamingElement=['XStreamingElement']
Res=[]
UVRectangle=['UVRectangle']
RemovedIndices=['RemovedIndices']
GenericDecalProjectorBase=['GenericDecalProjectorBase']
GenericDecalsMeshBase=['GenericDecalsMeshBase']
AppUtilPINVOKE=['AppUtilPINVOKE']
AppUtil=['AppUtil']
VersionInfo=[]
VariantExtension=['ConvertUtils']
ErrorMessages=['ErrorMessages']
Utils=[]
ActionExtensions=['Assert', 'AotHelper']
Json=['Json']
JsonExtensions=['JsonExtensions']
JsonFormatter=['JsonFormatter']
SimpleJson=['SimpleJson']
ReflectionUtils=['ReflectionUtils']
CacheResolver=['CacheResolver']
ApiBinding=['ApiBinding']
Tapjoy=['Tapjoy']
TJActionRequest=['TJActionRequest']
TJPlacement=['TJPlacement']
PlatformSettings=['PlatformSettings', 'Achievement']
FyberSettings=['FyberSettings']
ForegroundRealtimeClock=['ForegroundRealtimeClock']
SceneUsageTracking=['SceneUsageTracking']
JsonUtilityCompat=[]
SceneManagerCompat=['SceneManagerCompat']
UnityDependency=['UnityDependency']
Utils=['Utils']
ExecuteEvents=['ExecuteEvents']
RaycasterManager=['RaycasterManager']
AbstractEventData=['AbstractEventData']
AnimationTriggers=['AnimationTriggers']
CanvasUpdateRegistry=['CanvasUpdateRegistry']
DefaultControls=['DefaultControls']
FontUpdateTracker=['FontUpdateTracker']
GraphicRegistry=['GraphicRegistry']
MaskUtilities=['MaskUtilities']
Misc=[]
SetPropertyUtility=['SetPropertyUtility']
StencilMaterial=['StencilMaterial']
ClipperRegistry=['ClipperRegistry']
Clipping=[]
RectangularVertexClipper=['RectangularVertexClipper']
LayoutUtility=['LayoutUtility']
ReflectionMethodsCache=['ReflectionMethodsCache']
VertexHelperExtension=[]
BaseVertexEffect=['BaseVertexEffect']
ArabicFixer=['ArabicFixer']
ArabicMapping=['ArabicMapping']
ArabicTable=['ArabicTable']
TashkeelLocation=['TashkeelLocation']
ArabicFixerTool=['ArabicFixerTool']
Json=['Json']
AccessToken=['AccessToken']
CallbackManager=['CallbackManager']
ComponentFactory=['ComponentFactory']
Constants=['Constants']
FacebookSdkVersion=['FacebookSdkVersion']
MethodArguments=['MethodArguments']
ResultContainer=['ResultContainer']
FacebookLogger=['FacebookLogger']
Utilities=[]
FBUnityUtility=['FBUnityUtility']
CodelessIAPAutoLog=['CodelessIAPAutoLog']
FirebaseAnalytics=['FirebaseAnalytics']
FirebaseAnalyticsPINVOKE=['FirebaseAnalyticsPINVOKE']
ABSTweenPlugin=['ABSTweenPlugin']
Strong=[]
Sine=[]
Expo=[]
EaseInfo=['EaseInfo']
Utils=[]
TweenInfo=['TweenInfo']
EaseCurve=['EaseCurve']
Quart=[]
Bounce=[]
Elastic=[]
TweenEvent=['TweenEvent']
Quad=[]
Linear=['Linear']
ABSTweenComponentParms=['ABSTweenComponentParms']
OverwriteManager=['OverwriteManager']
Quint=[]
TweenWarning=[]
Path=['Path']
Cubic=[]
Circ=[]
Back=[]
TweenDelegate=[]
AddingNewEventArgs=['OperationResponse', 'EventData']
NotifyCollectionChangedEventArgs=[]
JsonSerializerSettings=['JsonSerializerSettings']
JsonConverter=['JsonConverter']
JsonConvert=['JsonConvert']
JsonSerializer=['JsonSerializer']
Base64Encoder=['Base64Encoder']
JsonTokenUtils=['JsonTokenUtils']
PropertyNameTable=['DigestHeaderParser']
ReflectionDelegateFactory=['ReflectionDelegateFactory']
ReflectionMember=['ReflectionMember']
ReflectionObject=['ReflectionObject']
StringReferenceExtensions=['StringReferenceExtensions']
TypeInformation=[]
ConvertUtils=['ConvertUtils']
DateTimeUtils=['DateTimeUtils']
EnumUtils=['EnumUtils']
BufferUtils=['BufferUtils']
JavaScriptUtils=['JavaScriptUtils']
CollectionUtils=['CollectionUtils']
MathUtils=['MathUtils']
MiscellaneousUtils=['MiscellaneousUtils']
ReflectionUtils=['ReflectionUtils']
StringUtils=['StringUtils']
TypeExtensions=['TypeExtensions']
ValidationUtils=[]
DefaultContractResolverState=['MonoTypeInfo', 'KSStruct', 'PlayerEditorConnectionEvents', 'ScrollViewState', 'OpJoinRandomRoomParams', '三三业丗丑丝丝丝丅', '丈万丙丌三丟丛万丕', 'LiderboardsMinigamesGameModeData']
ErrorContext=['ServicePoint']
JsonContract=['JsonContract']
JsonProperty=['JsonProperty']
JsonSerializerInternalBase=['JsonSerializerInternalBase']
JsonTypeReflector=[]
JsonLoadSettings=[]
JsonMergeSettings=[]
Extensions=['BuffersExtensions', 'Misc']
JPath=['TypeIdentifiers']
PathFilter=['PrimeGeneratorBase', 'AstNode', '丛丐丏丁丘万业专上', '丌丏三七七丟下丅七', '世丐与丂丗丙丘丞丆']
QueryExpression=['BsonToken']
BsonBinaryWriter=['BsonBinaryWriter']
BsonToken=['BsonToken']
BsonProperty=[]
BsonObjectId=['ASN1', 'WWWForm', 'BsonObjectId']
OakleyGroups=['OakleyGroups']
BigInteger=['BigInteger']
Version=['Version']
SupportClass=['SupportClass']
PhotonPeer=['PhotonPeer']
PhotonCodes=['PhotonCodes']
PeerBase=['PeerBase']
CmdLogItem=['CmdLogItem']
EnetChannel=['EnetChannel']
SerializationProtocolFactory=[]
IProtocol=['IProtocol']
OperationRequest=['OperationRequest']
OperationResponse=['OperationResponse']
EventData=['EventData']
CustomType=['CustomType']
Protocol=['Protocol']
IPhotonSocket=['IPhotonSocket']
SimulationItem=['SimulationItem']
NetworkSimulationSet=['NetworkSimulationSet']
TrafficStatsGameLevel=['TrafficStatsGameLevel']
TrafficStats=['TrafficStats']
pbTransformUtil=['FontUpdateTracker', '丝丗万一丌丈且丁丑']
pbUtil=['Unsafe', 'DefaultValidatorExtensions', 'FormatterResolverExtensions']
pb_ActionResult=['AGSAchievement']
pb_HsvColor=['SerializableVector4']
pb_XYZ_Color=['SerializableVector4']
pb_CIE_Lab_Color=['SerializableVector4']
pb_ColorUtil=['Dns']
pb_Constant=['Console', 'CachedReflectionInfo', 'HTTPManager']
EdgeExtensions=['上丄丗丅万丘专丁专']
pb_Face=['TextEditor']
pb_HandleUtility=['丑丞丘丒业丈不专丒']
pb_IntArray=['七丆且上丑丛丗丗丏']
pb_IntArrayUtility=['丕丝丈丟三世丈丐上']
pb_Log=['Marshal', 'MessagePackSerializer']
pb_Math=['丛不丟世业丝丄丐丅']
pb_MeshCompiler=[]
pb_MeshUtility=['丟且不丛三丒与三丅']
pb_Object_Utility=[]
pb_Projection=['Console', 'DefaultControls', '丝不丛丝七丒丗丆七', '丟且不丛三丒与三丅']
pb_SelectionPicker=['DefaultControls', '专丄丛丛三下万东万', '丝世丅不丈丝丝丂丑', '上丄丗丅万丘专丁专']
pb_ShapeGenerator=[]
pb_Shortcut=[]
pb_Smoothing=['丑丛丑下且丂丘丛世']
pb_Snap=['丂丕丄上业丟丄与下']
pb_Spline=['NavMeshBuilder']
pb_UV=['LTRect']
pb_UVUtility=['SceneManager', '丘一丘丂丛与丏丒丆', '丟一丕丑丟丈丝一丈']
pb_Bounds2D=['XmlSchemaSet', 'JsonProperty', 'EventDelegate']
pb_Color=['SerializableVector4']
pb_FaceRebuildData=['LTRect', '业世丞丛丗丆且丘丞', 'CrosshairData', 'PlayerGliderSettings', 'serializableUnityARMatrix4x4', 'serializableUnityARCamera', 'serializableUnityARPlaneAnchor', 'GameEventData', 'GameEventItemContainerData', 'PlayerStepsSoundsData', 'WeaponSkin']
pb_HandleConstraint2D=['HexCoords']
pb_RaycastHit=[]
pb_Submesh=['丈丅丕万丆且丄与世']
pb_Transform2D=[]
pb_UnwrapParameters=[]
pb_Vector=['丅东万东丏丐专一丂']
IOSWrapper=[]
BlurBase=['丟下专一丒丁三下丆']
Settings=['PhotonTransformViewPositionModel']
AdditioanlLoggingPlugin=[]
AFInAppEvents=[]
AmazonLogging=[]
AGSAchievement=['AGSAchievement']
AGSRequestResponse=['AGSRequestResponse']
AGSLeaderboard=['AGSLeaderboard']
AGSLeaderboardPercentile=['AGSLeaderboardPercentile']
AGSScore=['AGSScore']
AGSPlayer=['AGSPlayer']
GooglePlayDownloader=['丘丗业丞上不丟丐东']
meminfo=['meminfo']
MiniJSON=['MiniJSON']
MiniJsonExtensions=['MiniJsonExtensions']
openSettingsPlugin=[]
UAds=['UAds']
MeshContainer=[]
LerpControlledBob=['LerpControlledBob']
MeshContainer=[]
Quads=['Quads']
Triangles=['Triangles']
SKStoreReviewControllerManaged=['SKStoreReviewControllerManaged']
StdlibManaged=[]
UIDeviceManaged=['UIDeviceManaged']
AndroidNotificationConfiguration=['AndroidNotificationConfiguration']
EtceteraAndroid=['EtceteraAndroid']
GoogleIAB=['AndroidNotificationCenter', 'GoogleIAB', 'TwitterAndroid']
GooglePurchase=['GooglePurchase']
GoogleSkuInfo=['GoogleSkuInfo']
GoogleCloudMessaging=['GoogleIAB']
P31Prefs=['Logger']
StoreKitAppReceipt=['StoreKitAppReceipt']
StoreKitReceipt=['StoreKitReceipt']
StoreKitReceiptInAppItem=['StoreKitReceiptInAppItem']
TwitterAndroid=['TwitterAndroid']
MiniJSON=['MiniJSON']
MiniJsonExtensions=['MiniJsonExtensions']
Jsonable=['Jsonable']
AmazonLogger=[]
Json=[]
AmazonLogging=[]
Jsonable=['Jsonable']
AmazonLogger=[]
Json=[]
AmazonLogging=[]
RewardByTier=['丒丒与丂丑不三下一']
AdminSettingsController=['丙上丒丐丕一丞不东']
AlmanachController=['丟世丟七丛丙丑丑七']
AlmanachWeaponSet=[]
AlmanachCollectWeaponsStep=['AlmanachCollectWeaponsStep']
AlmanachMigrationSettings=[]
ScreenSize=['丄与丗世丌业丏丗丘']
WeaponUpParse=['东丛丛丙世丁丕不丟']
WeaponUpgradeParam=['三丛丁丑一且丘丞东']
GadgetParameters=['丙丏丕丑上丏丞丙丛', 'GameEventDropChanceData', '三与丆丝丐丟东丈东']
WeaponAbilityParameters=['丙丏丕丑上丏丞丙丛']
TransportParameters=[]
ModsBalance=[]
BonusAction=['不丄丙上丒丙丗下丛']
Bonus=['万丁下丄且三万且与']
SegmentUserBonusAction=['一丑丆丌丙丅一一丕']
WeaponUpParseV12=['丂丝与七上不丟七丄']
BtnCategoryDependent=['BtnCategoryDependent']
BuildNumberForInapps_NEW=['丝丙下万丑丏丁上业']
ResPath=['世丄丘专丆丑且丏七']
CategoriesKillrateStatistics=['上丛世丆丁丄七丘世']
ChestsPointsBattleRoyale=[]
VehiclePointsBattleRoyale=[]
ConsoleProDebug=['业丙丄万七丞丆下丞']
CurveAnimationEntry=['CurveAnimationEntry']
MaterialToChange=['MaterialToChange']
LocalizationStore=['万世丑丂丐下丟上东']
MeshOptimizer=['丘一丘丂丛与丏丒丆']
KillerInfoType=['丕丛丝三丏丆丐丙丛']
KillRateCheck=['丆丌丐丏七一丝专一']
KillRateStatisticsManager=['丁丅丂丂东丆丁丈三']
LoadAsyncTool=['不七丁丄丒丁丑丈七']
MinigameParameters=['丐丝丌东丛业丂丘三']
ScoreTableItem=['与丆丅丄丙三与七丟']
BMFont=['BMFont']
BMGlyph=['BMGlyph']
BMSymbol=['BMSymbol']
ByteReader=['与丒丏丝丑丑一丅丘']
EventDelegate=['EventDelegate']
Localization=['一与丛上丑与且丂上']
NGUIMath=['丕丝丈丟三世丈丐上']
NGUIText=['丙三丘丝一丂世不七']
NGUITools=['丛不丟世业丝丄丐丅']
PropertyReference=['PropertyReference']
UIGeometry=['丙一且丟丙丗丆上丕']
UISpriteData=['UISpriteData']
LayerMaskExtensions=['万丟世丙丁业丅丛与']
NJGTools=['丘下万丑专丞专丅下']
LTDescr=['一丈且下丏丆丂下一']
LTRect=['LTRect']
LTBezier=['丐丟且丝三且丐与下']
LTBezierPath=['上丕丄东丞一丗丟与']
LTSpline=['LTSpline']
LTEvent=['丅丞丝上七丛一丕丝']
LTGUI=['世不丐丞丗丁七丈丆']
OldFrameSelect=['丒不不丒丑丂万万丘']
CustomTypes=['丝丒丗丕丝丁丏且业']
EncryptionDataParameters=[]
Extensions=['丑丞丘丒业丈不专丒']
GameObjectExtensions=['丝不丛丝七丒丗丆七']
FriendInfo=['丛业丄丄丂丂丐丆丙']
OpJoinRandomRoomParams=['OpJoinRandomRoomParams']
EnterRoomParams=['三三业丗丑丝丝丝丅']
ErrorCode=[]
ActorProperties=[]
GamePropertyKey=[]
EventCode=[]
ParameterCode=[]
OperationCode=[]
RoomOptions=['业丒丁专丁不丆丛万']
RaiseEventOptions=['丈丅丕万丆且丄与世']
TypedLobby=['丏丂丐丏丂上丈丅业']
AuthenticationValues=['万三丗丅丞丂万丝丁']
PunEvent=[]
PhotonStream=['七丏丗下丞丕丁丂东']
SceneManagerHelper=['且下丈丄上不七下业']
WebRpcResponse=['丝七丌与七一丒丅三']
PhotonNetwork=['东丝丄世丆且丕丅上']
PhotonStreamQueue=['丕七业丗丒业丏丌世']
PhotonPingManager=['且丕丘下丙下上三三']
RoomInfo=['丘丝丗丆丄东丌业世']
Region=['与不丘丐专专丙东且']
PhotonTransformViewPositionControl=['丙丏丑丌丈丛且业丙']
PhotonTransformViewPositionModel=['PhotonTransformViewPositionModel']
PhotonTransformViewRotationControl=[]
PhotonTransformViewRotationModel=[]
PhotonTransformViewScaleControl=[]
PhotonTransformViewScaleModel=[]
CellTree=['丙丘东丟下与丌不丌']
CellTreeNode=['业世丞丛丗丆且丘丞']
ScoreExtensions=['与丁三丞一万丟丁丆']
TeamExtensions=['且七丛三且业丏不丝']
TurnExtensions=['丅东万东丏丐专一丂']
PixelGunLowWeaponsTable=['丝丟丂下丌丈与丞一']
PlayerEquipmentDataParser=['丟上丒世七专东世专']
PlayerEquipmentDefaultValues=['丟万一业丅丛丈专丒']
PlayerEventScoreController=['万下七丝七三世下丙']
PlayerSynchStreamSnapShot_Obsolete=['丘丌丂下丆丝丁丕专']
PromoActionMenu=['丘与丅丝三丗东七上']
PurchaseMiniGameItem=['与丟丂丄丐七丆一且']
RendererPainter=['丛丌丗丏丙且与丅丄']
SaltedIntArray=['丛三下丈七丒业丅不']
ABTestBase=['丞丙万丛丏世专丁丏']
WeaponsStats=[]
ZombieConfigurator=['丅丈一丈丒不丁万丑']
AdsEventData=['丝业丅丑业丝东业世']
AllPlayersInfo=['万一丅丞上丛丌丂丆']
AdvertisementInfo=['三下丝丑丞丕丕丅下']
AnalyticsHelper=['丞丝下三下丂丁业一']
ArrayListWrapper=['下上丁丂一丐丝丒丑']
Authorization=['丏上下丐丂丕丒丈丗']
AuthSceneLoader=[]
ConnectionHelper=['丕丏业丞丙专丑不世']
FirstStartNewProgress=['万万丕下丑丆丁丅丏']
PixelbookIdSyncChecker=['丂丙丗不丐且丅且丝']
PixelbookIdSynchronization=['丙丞业丘世丝丏世丂']
PreviousSocialIdTracker=['丛丆不不不三丄丝丄']
AuthorizationSessionKeyLifetime=['不万与丝三丆丑下丅']
BPEtcetera=[]
BPSlotChallenge=['下丑专且丕丟丒丌世']
BPSlotChallengeParser=['丗业丅上三丏专且下']
BPChallengeLocalization=['丂下且下丞不丏万七']
BPChallengeParams=[]
BattleRoyaleVehicleParser=['七世万丌丏丝丌世与']
CampaignLevel=['丌专丐丘丏丘世丙丕']
CampaignProgress=['且丌丒丕丁下与丑丞']
CampaignSettings=['丝东丅丙丛丁丙丒丝']
CheckContainsServerIds=[]
GadgetPanelEntry=[]
ClanChat=['业丁丘丁丆丅丈丝丞', '丐与丞丏且上丒丁业']
ClanChest=['PhotonPeer', '与丑万业东下丗上丂']
ClanChestData=['GameEventChestData']
ClanChestDropDescription=['GameEventData']
ChestsContainerObject=[]
Clan=['PhotonPeer']
ClanMember=['专丁下万世万且丞丐']
ClansLobbyMember=['与东丟丆东丄丕丝且']
ClanItem=['ClanItem']
ClanChestDropContainer=[]
ClanChestDrop=['ClanChestDrop']
JoinClanRequest=['丄丞丙东丕丛上丄不']
ClanSeason=['PhotonPeer', '丙七丌万三丑下下且']
ClanSeasonData=['StoreKitReceipt', '与东丟丆东丄丕丝且', 'GameEventData', 'GameEventChestData', 'DroppedItemData', 'FortItemState', 'BonusData', 'EggIncubatorProgress']
ClanSeasonsContainer=[]
ClanChestsPlayerData=[]
CloudHashInfo=['且丝上专丆东一丕丁']
ShopCraftManager=['XMLSchema', '上丅丘且专上万与丂', '丞东丝业丘丆七与专', '东丒丏万丛丒专三东']
CrosshairData=['CrosshairData']
CurrentCampaignGame=['丟丙丘七世三丑丛丞']
DeepLinkHandler=['丟丁丑业丈业丁丐不']
Defs=['丐丄丈丞东一丅上丂']
Device=['世万丆丏上一丂丕与']
EditorShopItemData=['AGSAchievement']
EggHatchingConditionFormatter=[]
LeveUpPanelShowOptions=['丅丘丟万一丂丐丁丑']
FortItemsInfo=['丛丐丕丌丏丕上丏不']
FortItemInfo=['东丝东且丑且丆丟丆']
RewardedVideoResult=[]
FriendsDeleter=['上上丄与丙且丕丅丘']
FriendshipInvitesAcceptor=['上上丄与丙且丕丅丘']
FriendshipInvitesIncoming=['丅丒丈丝与丛丞丕东']
FriendshipInvitesOutcoming=['丄上与丟丙丐丞万丁']
FriendshipInvitesRejector=['丛丑不与丕丈东丅丗']
FyberFacade=['丞丝下三下丂丁业一']
InterstitialResult=['三下丝丑丞丕丕丅下']
GadgetG=['且丅下丑丝下丑三丐']
GadgetsBalancesCompatibility=['三一丞丁七与下一一']
GadgetsInfo=['丐且丘七丙丒万上丂']
GadgetInfo=['丄东丅业一上世业丁']
GameCenterManagerLegacy=['不丌万东丗丕丅丙且']
GiftCategory=['GiftCategory']
GiftDataStructure=['PlaceableItemSettings']
GiftDataStructureSettings=['EggData']
GiftDataStructureDataUnit=[]
GiftDataStructureItem=['WeaponSkinTexture']
GiftDataStructureSlot=[]
GiftDataScheduleSlot=['PetInfo']
GiftInfo=['GiftInfo']
GiftNewPlayerInfo=['GiftNewPlayerInfo']
PlayerGliderSettings=['PlayerGliderSettings']
GlobalGameController=['丝丑业丏三万丗且丈']
HatsEquipManager=[]
ArmoryOffersHelper=['丞东丝业丘丆七与专']
BankExchangeItemData=['一丞上丏丆丂丘丌丝']
InappBonusesController=['三丏丐丑丝丏丏丆丅']
InappRememberedBonus=['InappRememberedBonus']
InGameGadgetSet=['东七业丗丒丕万丙丂']
ColorPreset=[]
LeaderboardsCrafterItemData=['下丙且丏业世万丅与']
LeaderboardsFriendItemData=['丑上七丁上丆丘不一']
LeaderboardsPlayerTrophiesItemData=['三万丆丙一丙三东丛']
LeaderboardsTournamentItemData=['一且三且丄丆丌丞丈']
LevelBox=['东上下丞丐丗丂一业']
LicenseVerificationController=[]
LobbyItemsInfo=['丑丂七万丏丕且丏丆']
LobbyItemInfo=['丗业专业上丌万与专']
OurLobbyLikes=['丕丏丈且不丂三与丒']
LobbyLikes=['业丁丘丁丆丅丈丝丞']
Log=['业丙丄万七丞丆下丞']
InteractionController=['丈世丈丙丑丑一丌上']
InteractionKillrate=['丏丁丁丗丑丌丆丞下']
MatchmakingController_=['丄丝万丆丕专且世不']
MatchmakingData=['丐与丙丞丞丂丟丛万']
MatchmakingGameMode=['专丙且七丁下专专丑']
TierMatchmakingController=['万丅东世专丙丌且世']
TierMatchmakingData=['一丂三丝丌丑丌丒丂']
TierMatchmakingGameMode=[]
TierMatchmakingMapGroup=['RegexBoyerMoore', '丅丑与丑业且且丏丏', '一七丒丆丄丒且不丌']
MobileAdManager=['丘三专丙东丗万丄东']
ModuleChestsController=['丕与丂丂七三不丄丌']
ModuleChestData=['ModuleChestData']
ModuleChestsDataContainer=[]
CommonModuleChestsSettings=[]
OfferItemWithProbability=['OfferItemWithProbability']
OfferItemWithProbabilityList=['丈丙专一丌丑丆丑丂']
ModulesTutorial=['丙三丙丗丈丝七下丗']
PlayerModules=['丏丝丁丘丞丂丌东丗']
MyFriends=['丘丙业丕丛丐丘丞业']
MyPlayerInfo=['丘三专丙东丗万丄东']
MyPlayerInfoDiff=['一丄丐丐丙东丙丘丙']
NewItemsSystem=['丕世与丑丟丗丝丗丕']
NewItemsList=[]
NewItem=['NewItem']
OnlineInfoDiff=['专丌世且丄与丕丄下']
HandSetPet=['万丑丈且专丐丂不丈']
PetsInfo=['不丂丟与丘丏丑丘丄']
PetInfo=['PetInfo']
PhotonTrafficStatistic=['下丗丑不丅与丗丞丕']
ArmoredWear=['丞丟丏专丒丏不七丕']
PlayerArmor=['丛丕东丒世万七丄丌']
PlayerBan=[]
PlayerBotWeapon=['丞丗东世不丆与丕丆']
PlayerIdResetter=['不丒不丈丑丅丐丏丛']
PlayersOnlineInfo=['丐丕丆万丙世业一丄']
PossibleFriends=['万一丅丞上丛丌丂丆']
PrivateChat=['丐与丞丏且上丒丁业']
ProgressChoiseResult=['丈丏下业东丄丐世世']
ProgressHash=['丙万业三下业专丛丐']
QuestGSFactory=['丑丄丌丗且一丌丕丘']
QuestGS=['丟下且下丁一丘专丘']
QuestsAndTasksState=[]
TaskGS=['丄不丏下丅丌丙专上']
RandomsProvider=['丕丛丅丝下业七丑七']
RewardMultiplicator=['丄丛丝世丕且丙世万']
RoyaleCustomizationItemsManager=['三丛与丈丆丄丄世一']
RoyaleCustomizationItem=['丞专丞丂丈七丕专三', '万丞丕丝丛下上丝丘']
AllScenesForMode=['AllScenesForMode']
ScopeViewGameEvent=['丕一丏丒丒丂丄丁丂']
ScopeViewGameEventSettings=['ScopeViewGameEventSettings']
PlayerSocialInfo=['业七且万丗丗丝丐不', '丐丞不东丌不丂丁东']
RemoteFullProgressInfo=['丞世下一一丗丑丙万']
RemoteProgressInfo=['丐丞不东丌不丂丁东']
ServerLogs=[]
GameEventProgress_Chests=['丑专下丂丅丆丞丂丝']
GameEventProgress_Roulettes=['丛上且丅丘丒丌丆丈']
SocialIdForProgressManager=['不丈丅丐与丈业丐上']
SocialIdProvider=['丏业东专上丟上丒丞']
ValidationController=[]
ServerTechnicalWork=['下专丘丄丐丈丘丆丕']
AddModelHelper=[]
EquipHelper=['丂万丅丂且不世业丂']
ClassItemsEditorHelper=['且七丛三且业丏不丝']
ProvideItemHelper=['专丅且不丑丑丆丅且']
ShopGuiHelper=[]
ShopHelper=['丙丘丞七丝一业丆丁']
ShopCellCreaterHelper=[]
ShopTutorialHelper=[]
WearVisibilityHelper=['丝三丒不丁丕与丟丟']
TryGunHelper=['DateTimeFormat', '__Error', 'AsyncCausalityTracer', 'X509Helper2', 'ValidateNames', 'ManagedStreamHelpers', 'Internal_SubsystemInstances', 'Services', 'ThrowHelper', '丛丌丗丏丙且与丅丄', '丘丗东丅丝丒丘丗丒', '不丒不丈丑丅丐丏丛', '丅业且丂丝上丘丑丘', '专丅且不丑丑丆丅且', '不下丏专丑丆三业丛', '丑上不与丐专东丟七', '丗丁丞丈丏专丛七丂', '且丒不丝丘东丝丅业', '丆世业丞丁三下丆丐', '丑丕且东七丐丞业丟', '且不丙丂丘丝不三丛', '丅丒业丐丄丂业三丏', '丆下丅丌上丁丐丕丌', '丙丅世一下丝世业下', '万专且丌专且下丝丄', '一世丌丅丄世七丗下', '业业万丅丕丙东丁丗', '世三丕丄丆与丝丟丌', '丝不且且不下丅专一', '丌丗世与丏业丝且丂']
UnlockedItemsHelper=['EncodingTable']
CraftSetsManager=['三万丝业丛丂万丁业']
CraftSet=[]
SquadInvites=['东上丏丌丒丅专不丛']
MiscGridModifier=['丘丆丘丒且丒三丁丈']
Storager=['丆丅下丂丙万一一专']
AmazonStatus=[]
SubscriptionNewsEmail=['下专且专丂七丂七下']
TierDiscounts=['一且丘丞一一丘丏七']
TournamentLeagueSettings=['X10Data', 'GameEventData', 'GameEventChestData', 'FortItemState', 'BonusData']
TournamentLeagueSettingsContainer=[]
TournamentLeaderboard=['TournamentLeaderboard']
TournamentPlayer=[]
ChangableBasicSprite=['ChangableBasicSprite']
ContextMenuController=['丏七业上丒丗丏丙七']
URLs=['丛一丑一东丏三丒万']
PixelbookCharactersBundle=['丐丞东丝专丈专东丌']
PixelbookCharacter=[]
UserCharacterManager=['丐丑丂与丝丒丄丅业']
NewCharacterData=['一不丙丕专业丅丛下']
RiliExtensions=['丞上丈不丄专丞丌丂']
VirtualCurrencyHelper=[]
WeaponAnimEffectData=['WeaponAnimEffectData']
FilterMapSettings=[]
WeaponUpgradeV7=['丐丛东丈丞业业丐丁']
WeaponUpgradeV8=['丅丅七东丞万不丏丅']
WeaponUpgradeV9=['与丒丛与一丘业万丞']
ItemUpgrade=['丂丏丄丟丌丙丗丑丅']
TryGunOfferInfo=['丐丅一三丏万七丙世']
TryGunInfo=['业丕东丗丒专丈丑丞']
ItemDbRecords=[]
ItemDbRecords_Migration_0617=['丞丆与丙专一业下丞']
WeaponW=['丆丗丟世丏与上丄丒']
UpgradingArmor=[]
Wear=['丐且丘七丙丒万上丂']
WearInfoContainer=['不丛不上丙且东丁万']
X10Data=['X10Data']
X10Rule=['X10Rule']
SiegeCharacter=['一世专丙丅丁丒丝丐']
SkinsManager=['业丏丌丂丏丅丈丂丒']
WebViewStarter=['丑丄丌丗且一丌丕丘']
AlternativeAttackSettings=['AlternativeAttackSettings']
BaseAlternativeAttack=['丈丟丟丘丟丂丟丏丗']
AlternativeAttackCommonSetting=[]
BaseTriggerAlternativeAttack=['BaseTriggerAlternativeAttack']
TriggerAlternativeAttackFactory=['万世丕丛丘丈业与不']
TriggerAlternativeAttackSetting=['TriggerAlternativeAttackSetting']
TargetInfo=['世丕丟且业万下丁丌']
AIBotSettings=['丛丘七丟丂且万且丁']
CameraTouchControlScheme=['丗丏万丆与丞丆丌三']
DataPacker=['万世三丆与上丘丕下']
FactoryScenario=[]
Scenario=['丅丂丕丌丄丆丌七万']
EffectsController=['一丐世丟丒丞丄与世']
EffectsParameters=['七上与三丘丘万丐丑']
Friend=['丁三丞丂丑下丁丂专']
FilterBadWorld=['一丅丆七丁丏不三丗']
GameLoopShopHelper=['与一丙丏丘下丞专丞']
GearManager=['东丄业世丟丞丈丆丝']
ItemRecord=['ItemRecord']
ItemDb=['世丏世且世业丅不丛']
WeaponComparer=['丅丆丞丕一七丙丙丒']
WeaponTags=['丂一丆丕三不丌丄丐']
SquadPlayerInfo=['丄万丗上丘丐不且业']
Defs2=['丏与与丅不丁丙丈东']
PlayerPrefsX=['不业世丗东丛下丆不']
RandomGenerator=['丗下丂丂上且上丆且']
TWTools=['丈丌专丙丕专丝丂与']
UniPasteBoard=['丌三丙丝丑丕与上丌']
VersionChange=['VersionChange']
VersionChangeText=[]
WeaponCategoryStatistics=['丝丐丄丞世丘丛丝丐']
WeaponSkinParser=['丝丕丑丒丅丛专丄东']
WeaponSkinSettingsManager=['丒且丂丄万丛丟丕丈']
CryptoPlayerPrefs=['丑丛丑下且丂丘丛世']
ObjectSerializationExtension=['丒丄丏丆丗丅三丌丂']
SerializableVector4=['SerializableVector4']
serializableUnityARMatrix4x4=['serializableUnityARMatrix4x4']
serializableUnityARCamera=['serializableUnityARCamera']
serializableUnityARPlaneAnchor=['serializableUnityARPlaneAnchor']
serializablePointCloud=['serializablePointCloud']
serializableARSessionConfiguration=['serializableARSessionConfiguration']
serializableARKitInit=[]
serializableFromEditorMessage=[]
ConnectionMessageIds=['丅东七丛丄丅丒世不']
SubMessageIds=['丒丞丙丏上丑丄丙专']
ARPlaneAnchorGameObject=[]
UnityARAnchorManager=['丕丘一业丌一业丁万']
UnityARMatrixOps=['专东丞一丝一丂东专']
UnityARUtility=['不东且丙世万丟东丞']
UnityARSessionNativeInterface=['丁丝丂丌下万丙丅丒']
TapticManager=['丑不丅丝丌丆三丘下']
BaseAIBotBehavior=['且七丁丝七丟丁丑七']
ColliderUtils=['丙丘丅丏不世下且丑']
ProgressAnalytics=['上下世一万丙丐万丏']
ProgressConverter=['丛丙丘丒丆东丝与丁']
ReadableProgressData=['丕丕丛丑丄与丆东且']
SendProgressResult=['丌东丁七专丏七业丆']
ProgressServerMigration=['与丈万丝丕丙丘丁丞']
ProgressPause=['丕丙丝世下东且与万']
ProgressResume=[]
ProgressSyncController=['一专丏东丐丅丟下丅']
ProgressUpdater=['与丕丂丒丗且丐丈丟']
RemoteSlotCreator=[]
Slot=['一丛丙三不丗下业丁']
SlotHasher=['业丌丐丝丕丗丁丆丗']
CommandHasher=['丑丌七丌下丆三丑丈']
SlotSendParams=['丑丒三丏丂丛专万三']
SlotsController=['丗丐丁丝不丗丙丐上']
GadgetsInfoBeforeCombatLevels=['丌丘不丐丝丐一丏丂']
PluginBridge=[]
Utils=[]
FyberLogger=[]
RequestError=['丟世丟七丛丙丑丑七', '世丈丂丗丄世丗丛上', '七不丈丘不丘丞丞丐']
Ad=[]
AdResult=['CspKeyContainerInfo']
FyberCallback=['丝丑业丏三万丗且丈']
VirtualCurrencyErrorResponse=[]
VirtualCurrencyResponse=['FyberSettings', 'Achievement']
BotDebuff=['丁丐不丐丐一东丘丆']
TutorialState=['不丗上丌上丏东丁丌']
pg_Constant=[]
pg_Enum=['丂丕丄上业丟丄与下']
pg_Util=['上丄丗丅万丘专丁专']
PGExtensions=['世上丝丌且丝丁丟丗']
PlayerRoomIndexingExtensions=[]
ChatChannel=['ChatChannel']
ChatEventCode=[]
ChatOperationCode=[]
ChatParameterCode=[]
AuthenticationValues=['AuthenticationValues']
ParameterCode=[]
ErrorCode=[]
ChatUserStatus=[]
TimeKeeper=['TimeKeeper']
GizmoTypeDrawer=['GizmoTypeDrawer']
MoreEnumerable=['丕丄丕且下三丏万丞']
GameObjectBuilder=['丕且东一七且丟东丄']
GameObjectExtensions=['丝不丛丝七丒丗丆七']
JSONNode=['下丐丘丙七三一丁不']
JSON=[]
EventCallback=['EventCallback']
GoogleLanguages=['丞丒丆丒东丈一丗丝']
TermData=['WeaponSkin']
LanguageData=[]
LocalizationManager=['世丌不丟丐丏上丕丆']
LocalizationReader=['业丗下丞丏业下七丂']
ScriptLocalization=['丄世丞世丗丒丟丕万']
Extensions=['丑丞丘丒业丈不专丒']
JsonMapper=['丟且不丛三丒与三丅']
JsonReader=['专万东丝丄丂下丌丆']
WriterContext=['丞丆丘丑丙不上三丟']
JsonWriter=['丈与专丒丆丕丞专丏']
FsmContext=['丁业丑丛专三上丐丗']
Lexer=['丗下丙下丘丛世专丅']
JavaObjWrapper=['AndroidJNIHelper', 'Object']
GameInfo=['GameInfo']
NearbyConnectionClientFactory=[]
PlayGamesClientFactory=['PlayGamesClientFactory']
PluginVersion=[]
CallbackUtils=['且专丏丕丈万不万丛']
ConversionUtils=[]
JavaUtils=[]
NativeNearbyConnectionClientFactory=['丐丞不东丌不丂丁东']
AchievementManager=['丁丟丂丒丄万丛丗丈', '丕丅丙丅丑丏丌下丏']
Callbacks=['SpanHelpers', 'Formatter']
EventManager=[]
LeaderboardManager=['丞丝丞丄上不七丘丒', '七丗东丙不专业上业', '丕丅丙丅丑丏丌下丏']
PInvokeUtilities=['世七下且丕丞业丞三']
PlayerManager=['ThreadHelper', 'TaskExceptionHolder', '丁丐丘下下丂丘下丆', '丁丟丂丒丄万丛丗丈', '丐与丞丏且上丒丁业', '丕丅丙丅丑丏丌下丏']
RealtimeManager=['七丕一丐且丗丅不丙']
SnapshotManager=['七丕一丐且丗丅不丙']
StatsManager=['丁与丘万上下丌上丑']
TurnBasedManager=['七丕一丐且丗丅不丙']
VideoManager=['七丕一丐且丗丅不丙']
Achievement=['HashHelpers']
AchievementManager=['HashHelpers']
AndroidPlatformConfiguration=['HashHelpers']
Builder=['HashHelpers']
CaptureOverlayStateListenerHelper=['丒丑与专丐丙丅丐世']
CommonErrorStatus=[]
EndpointDiscoveryListenerHelper=['HashHelpers', '丒丑与专丐丙丅丐世']
Event=['HashHelpers', '丒丑与专丐丙丅丐世']
EventManager=['HashHelpers', '丒丑与专丐丙丅丐世']
GameServices=[]
InternalHooks=['丒丑与专丐丙丅丐世']
Leaderboard=['HashHelpers', '丒丑与专丐丙丅丐世']
LeaderboardManager=['丑丙丅下东丐丗且丝', '东七业丗丒丕万丙丂', '丕世与丑丟丗丝丗丕', '丘丏丂丌丟不上丞丒']
MessageListenerHelper=[]
MultiplayerInvitation=['HashHelpers']
MultiplayerParticipant=['HashHelpers']
NearbyConnections=['RuntimeMarshal', 'ReflectionExtensions', 'SpanHelpers', 'AppContextSwitches', 'ParseNumbers', 'ConsoleDriver', 'KnownTerminals', 'ParameterizedStrings', 'EncodingHelper', '__Error', 'TimeSpanFormat', 'TimeSpanParse', 'EncodingTable', 'TextInfoToUpperData', 'TextInfoToLowerData', 'PlatformHelper', 'ThreadPoolGlobals', 'NativeEventCalls', 'AsyncCausalityTracer', 'TaskToApm', 'X509Helper', 'AsyncTaskCache', 'JitHelpers', 'HashHelpers', 'UnityTls', 'MonoTlsProviderFactory', 'SystemCertificateValidator', 'NativeMethods', 'SecurityUtils', 'UriHelper', 'IPv4AddressHelper', 'IPv6AddressHelper', 'Platform', 'CompModSwitches', 'X509Helper2', 'NclUtilities', 'ValidationHelper', 'ExceptionHelper', 'TimerThread', 'EnumerableHelpers', 'AsyncHelper', 'Bits', 'ValidateNames', 'Error', 'TypeExtensions', 'WebRequestUtils', 'BigNumber', 'NumericsHelpers', 'Internal_SubsystemInstances', 'Internal_SubsystemDescriptors', 'Services', 'SR', 'EnumUtils', 'ImmutableCollectionsUtils', 'JavaScriptUtils', 'MiscellaneousUtils', 'StringUtils', 'TypeExtensions', 'DecimalDecCalc', 'Number', 'ReadOnlySequence', 'ForegroundRealtimeClock', 'Utils', 'FacebookLogger', 'Requires', 'Utilities', 'ReflectionExtensions', 'OakleyGroups', 'PhotonCodes', 'LazyCollectionExtensions', 'Extension_Methods', 'LinqHelpers', 'ModuleRegister', 'LexerUtils', 'SerializationExtensions', 'JsonTableConverter', 'DescriptorHelpers', 'InteropRegistrationPolicy', 'Tools', 'NumericConversions', 'TableConversions', 'MemberDescriptor', '丆丅丝不万丑丆丅东', '丆丆丘丝丕丞东丝丛', '丑丟丗丗丈且丑丏上', '丝丒丗丕丝丁丏且业', '丛丌丗丏丙且与丅丄', '万丆丗丘与丈世七丄', '丂不丅且丒丅丂丁七', '丘丗东丅丝丒丘丗丒', '丗业丅上三丏专且下', '丝东丅丙丛丁丙丒丝', '丈下下丑丛丒且专丕', '三丒丞丕专业丟一丁', '丄丅丅万丝丕丕丗丁', '七丕丂丆与丐下丂丕', '七丄与世丄万丟丁丗', '三一丞丁七与下一一', '丁下丑丙三丈丗丕上', '丝丅专丁丝丞万丏丂', '不丒不丈丑丅丐丏丛', '不丈丅丐与丈业丐上', '专丅且不丑丑丆丅且', '不下丏专丑丆三业丛', '丆下专一丕业丛万三', '一且丘丞一一丘丏七', '与丘丅丟丘不丘东三', '丏七业上丒丗丏丙七', '七上与三丘丘万丐丑', '丄丈不且丟专丞丟专', '丙上丟丛丞丆丆丛丟', '下三丛丄万丁丌万业', '一专丏东丐丅丟下丅', '业丌丐丝丕丗丁丆丗', '与丟丝万上专丛丅丌', '丑上不与丐专东丟七', '丗丁丞丈丏专丛七丂', '丟丆不万东丏丈丅七', '丐丈一丏丘丘丕七丂', '且丒不丝丘东丝丅业', '且丐丁丟丛与丛丙一', '丆世业丞丁三下丆丐', 'InternalConstants', '万丅丅丕丆丆丐丞一', '丑丟丐丅一七丈丄丗', '丑丕且东七丐丞业丟', '丅七三丐丅丞丁东丕', '丁丈丒丘与丙丛不丅', '专丂丆丈丙七丈丁丄', '丐丑丅丄丟世丞丘业', '东七丐丅下丆丑丈三', '万丑丄丛丛与业专丞', '世上丟丁丘丈丂七专', '且不丙丂丘丝不三丛', '丑不世东丝丗三丕三', '丙丑丌七丒丕丟丟丂', '丅丒业丐丄丂业三丏', '丝世丐丌丕丝丆专丗', '丈与业七不丛丕丈丙', '专三一丑丞一丂万丕', '丆下丅丌上丁丐丕丌', '丞丙万丑丏丑丒丆一', '不七东丝七丒丅上丘', '业不且东丞丐与一丄', '丝下丑三丗一丏丐丒', '业丒专丒上七丂万丟', '业下丅丏丈丂上三丏', '丌万丌丅专丁丁业上', '业丈丂丁世七丗丈七', '丆且且丝丆丄七上丈', '一世丌丅丄世七丗下', '业业万丅丕丙东丁丗', '东丄丂专与丂丛丝丙', '丕丈丒丕丐专丕业东', '丅丂丙丐丑上东万万', '丘丕专丕与丁一丄丑', '丟丁与下丙丁丝丕丝', '丐上丙丙丌东丏丙世', '丑丝下世丙丏丝业一', '丌丗世与丏业丝且丂', '东丂一丏丏丕丛上东', '丛丂一丈上丐丙丁丞', '三丈下专丌丟业一丈', '东下业丙丅丁丒东丒', '丟丂丌丄丒万丒丒丟', '世七丟不丒世丅丐丆', '东丌丈丒丝丗丑丗丘', '世丂丐丒丒与丆不丗', '业丘丞东丛丘丌丁三', '一与丟世丂丂一七丂']
NearbyConnectionsBuilder=[]
NearbyConnectionsStatus=[]
NearbyConnectionTypes=['RuntimeMarshal', 'ASN1Convert', 'ReflectionExtensions', 'SpanHelpers', 'AppContextSwitches', 'DateTimeFormat', 'CompatibilitySwitches', 'ParseNumbers', 'ConsoleDriver', 'KnownTerminals', 'MonoCustomAttrs', 'ParameterizedStrings', 'StringBuilderCache', 'EncodingHelper', '__Error', 'TimeSpanFormat', 'TimeSpanParse', 'EncodingTable', 'TextInfoToUpperData', 'TextInfoToLowerData', 'PlatformHelper', 'ThreadPoolGlobals', 'NativeEventCalls', 'AsyncCausalityTracer', 'TaskToApm', 'Utils', 'X509Helper', 'BinaryCompatibility', 'BinaryConverter', 'AsyncTaskCache', 'JitHelpers', 'Unsafe', 'HashHelpers', 'SR', 'UnityTls', 'UnityTlsConversions', 'CFNetwork', 'MonoTlsProviderFactory', 'SystemCertificateValidator', 'CallbackHelpers', 'NativeMethods', 'SecurityUtils', 'IriHelper', 'UriHelper', 'IPv4AddressHelper', 'IPv6AddressHelper', 'Platform', 'TraceInternal', 'CompModSwitches', 'X509Helper2', 'NclUtilities', 'ValidationHelper', 'ExceptionHelper', 'TimerThread', 'EnumerableHelpers', 'LocalAppContextSwitches', 'AsyncHelper', 'Bits', 'BinaryCompatibility', 'ValidateNames', 'SR', 'Error', 'ArrayBuilderExtensions', 'CollectionExtensions', 'ContractUtils', 'ExpressionUtils', 'TypeExtensions', 'ManagedStreamHelpers', 'WebRequestUtils', 'BigIntegerCalculator', 'BigNumber', 'NumericsHelpers', 'Internal_SubsystemInstances', 'Internal_SubsystemDescriptors', 'SR', 'ADP', 'SqlConvert', 'ActivePlatform', 'Native', 'PlatformInformation', 'Services', 'SR', 'RaycasterManager', 'SetPropertyUtility', 'AppUtilPINVOKE', 'ConvertUtils', 'EnumUtils', 'ImmutableCollectionsUtils', 'JavaScriptUtils', 'MiscellaneousUtils', 'StringUtils', 'TypeExtensions', 'DecimalDecCalc', 'Number', 'SR', 'ReadOnlySequence', 'ThrowHelper', 'ForegroundRealtimeClock', 'Utils', 'Constants', 'FacebookLogger', 'Requires', 'SafeBitConverter', 'SequenceReaderExtensions', 'StreamPolyfillExtensions', 'Utilities', 'ExpressionUtility', 'FarmHash', 'ReflectionExtensions', 'DynamicGenericResolverGetFormatterHelper', 'OakleyGroups', 'PhotonCodes', 'HashHelpers', 'LazyCollectionExtensions', 'KeyTuple', 'Extension_Methods', 'ScriptPrivateResource_Extension', 'LinqHelpers', 'LuaTypeExtensions', 'ModuleRegister', 'LexerUtils', 'Loader_Fast', 'SerializationExtensions', 'JsonTableConverter', 'DescriptorHelpers', 'InteropRegistrationPolicy', 'Tools', 'TypeDescriptorRegistry', 'ClrToScriptConversions', 'NumericConversions', 'ScriptToClrConversions', 'TableConversions', 'MemberDescriptor', 'Framework', 'MiniJsonExtensions', '丆丅丝不万丑丆丅东', '丐丗丕丌下丛丞上丈', '丆丆丘丝丕丞东丝丛', '丑丟丗丗丈且丑丏上', '丝丒丗丕丝丁丏且业', '丄丂丂丘上丌丄不且', '丛丌丗丏丙且与丅丄', '万丆丗丘与丈世七丄', '丂不丅且丒丅丂丁七', '丘丗东丅丝丒丘丗丒', '丗业丅上三丏专且下', '丝东丅丙丛丁丙丒丝', '丈下下丑丛丒且专丕', '三丒丞丕专业丟一丁', '丄丅丅万丝丕丕丗丁', '七丕丂丆与丐下丂丕', '七丄与世丄万丟丁丗', '三丘万且丐万三三丝', '丑丙丅下东丐丗且丝', '丞丆丗三丁丛与丙丏', '三一丞丁七与下一一', '丁下丑丙三丈丗丕上', '丙丟丑丁丞丗且丕丛', '东七业丗丒丕万丙丂', '丝丅专丁丝丞万丏丂', '丕世与丑丟丗丝丗丕', '不专丙丕丛丑丞丄一', '不丒不丈丑丅丐丏丛', '丕丛丅丝下业七丑七', '三丛与丈丆丄丄世一', '丂丈一三丒专三不丈', '不丈丅丐与丈业丐上', '专丅且不丑丑丆丅且', '不下丏专丑丆三业丛', '丝三丒不丁丕与丟丟', '丆下专一丕业丛万三', '一且丘丞一一丘丏七', '与丘丅丟丘不丘东三', '丏七业上丒丗丏丙七', '七上与三丘丘万丐丑', '丄丈不且丟专丞丟专', '丈且丟丘与丐与专丒', '丙上丟丛丞丆丆丛丟', '下三丛丄万丁丌万业', '世丈丄丏丛丘七下上', '下丟丑与丅丂丘丏丁', '上下世一万丙丐万丏', '丕丙丝世下东且与万', '一专丏东丐丅丟下丅', '业丌丐丝丕丗丁丆丗', '丑丌七丌下丆三丑丈', '丕丄丕且下三丏万丞', '丄下东丘丒丐一上丟', '与丟丝万上专丛丅丌', '丄丘丙丐丝丆且丕一', '一丟丅丒与丈丝丕丁', '与三万丗业丙丆万丝', '丑上不与丐专东丟七', '专丅丆丟专丏与业丌', '万一七丏不丄丛丘丑', '丗丁丞丈丏专丛七丂', '丟丆不万东丏丈丅七', '丐丈一丏丘丘丕七丂', '且丒不丝丘东丝丅业', '万业东丐丑不丗丗丛', '上与万丟三丗丅丂一', '且丐丁丟丛与丛丙一', '丆世业丞丁三下丆丐', '上丕丏丈丙丝且丝丒', '且专丏丕丈万不万丛', '丝丕一丒上下不丅丕', 'InternalConstants', '万丅丅丕丆丆丐丞一', '丑丟丐丅一七丈丄丗', '丑丕且东七丐丞业丟', '丑丈丑丝上丗丕万丗', '丅七三丐丅丞丁东丕', '丁丈丒丘与丙丛不丅', '丝丙丞业三不业与丏', '专丂丆丈丙七丈丁丄', '丞东丅不且丑丝丅丆', '丐东丄丝丞七丞一不', '丐丑丅丄丟世丞丘业', '东七丐丅下丆丑丈三', '丛丑丗丗丁丙丄且丑', '上七丈丏三丝丏丆且', '万丑丄丛丛与业专丞', '世上丟丁丘丈丂七专', '且不丙丂丘丝不三丛', '丁丟丐与专专丛七丝', '下且丟丆一七不丑与', '丅丅丏丟丘丞丟上万', '丑不世东丝丗三丕三', '下东业丒丄丝与丁万', '丙丑丌七丒丕丟丟丂', '七丑丘丁且业专下丐', '丂丛三不丕丕万丗丆', '丅丒业丐丄丂业三丏', '丝世丐丌丕丝丆专丗', '丈丝万丙上丄丟三丑', '丈与业七不丛丕丈丙', '专三一丑丞一丂万丕', '丆下丅丌上丁丐丕丌', '丞丙万丑丏丑丒丆一', '丛专丞丝丕业丒一与', '不七东丝七丒丅上丘', '丟丙丕丞丂三世丛丏', '业不且东丞丐与一丄', '丝下丑三丗一丏丐丒', '丞丆丄世世丑万丌丈', '丙上丝且丄丝与丆专', '业丒专丒上七丂万丟', '丑下世丑丝丅东丑七', '与丏丄专上丆丁一丈', '丘丄丐丟不丌东世丝', '业下丅丏丈丂上三丏', '万专且丌专且下丝丄', '丌万丌丅专丁丁业上', '丛下丂丒万专下万且', '业丈丂丁世七丗丈七', '丆且且丝丆丄七上丈', '丞丁万丏丞丈世丌丛', '一世丌丅丄世七丗下', '丕丆下与丂丝丏上丕', '丆丕万且丑世万世业', '业业万丅丕丙东丁丗', '丁丌不上丗丕一丂丂', '东丄丂专与丂丛丝丙', '且丂世丗丐丛丑不三', '丒丑与专丐丙丅丐世', '且万丌丙东万丌一专', '丕丈丒丕丐专丕业东', '不且世七丞不丗丁且', '一丈万丅世东丒丄丞', '世三丕丄丆与丝丟丌', '且专一丟丑丐丏一丁', '丗业七丟与丛丅丑丘', '丅丂丙丐丑上东万万', '丘丕专丕与丁一丄丑', '丟丄丑且丅丄世与丗', '丟丁与下丙丁丝丕丝', '丝不且且不下丅专一', '丐上丙丙丌东丏丙世', '专不丗丞丗丆丐三东', '丑丝下世丙丏丝业一', '丌丗世与丏业丝且丂', '世世三且三不东丝丄', '与丛丅丝丈丟丈丅与', '东丂一丏丏丕丛上东', '丂世丂丂丒下不丕丑', '三三业万上丒丞且丌', '丘丏丂丌丟不上丞丒', '与丁丂丟丙上丕丂丐', '不丌下丛三丘丞丒丙', '丟三上丐丑丑丂丛丄', '丛丂一丈上丐丙丁丞', '三丈下专丌丟业一丈', '丂丒与上万东丕专专', '东下业丙丅丁丒东丒', '丟丂丌丄丒万丒丒丟', '丕丈丙丙世专三且丙', '上业且丘丞丗下上丕', '世七丟不丒世丅丐丆', '东丌丈丒丝丗丑丗丘', '世丂丐丒丒与丆不丗', '业丘丞东丛丘丌丁三', '一丏丏丏丒专丙丅丐', '一与丟世丂丂一七丂']
ParticipantResults=[]
Player=['HashHelpers', '丒丑与专丐丙丅丐世']
PlayerManager=['ParseNumbers', 'ConsoleDriver', 'ParameterizedStrings', 'EncodingHelper', '__Error', 'TimeSpanParse', 'EncodingTable', 'TextInfoToUpperData', 'TextInfoToLowerData', 'X509Helper', 'AsyncTaskCache', 'HashHelpers', 'CFNetwork', 'MonoTlsProviderFactory', 'SecurityUtils', 'UriHelper', 'NclUtilities', 'ValidationHelper', 'TimerThread', 'EnumerableHelpers', 'ValidateNames', 'ContractUtils', 'BigIntegerCalculator', 'BigNumber', 'SqlConvert', 'Services', 'EnumUtils', 'JavaScriptUtils', 'StringUtils', 'TypeExtensions', 'Extension_Methods', 'ModuleRegister', 'LexerUtils', 'JsonTableConverter', 'DescriptorHelpers', 'Tools', 'TableConversions', '丐丗丕丌下丛丞上丈', '丝丒丗丕丝丁丏且业', '万丆丗丘与丈世七丄', '丝东丅丙丛丁丙丒丝', '三丒丞丕专业丟一丁', '丑丙丅下东丐丗且丝', '三一丞丁七与下一一', '丁下丑丙三丈丗丕上', '东七业丗丒丕万丙丂', '丝丅专丁丝丞万丏丂', '丕世与丑丟丗丝丗丕', '不丒不丈丑丅丐丏丛', '不丈丅丐与丈业丐上', '专丅且不丑丑丆丅且', '不下丏专丑丆三业丛', '丆下专一丕业丛万三', '一且丘丞一一丘丏七', '与丘丅丟丘不丘东三', '丏七业上丒丗丏丙七', '丄丈不且丟专丞丟专', '下三丛丄万丁丌万业', '一专丏东丐丅丟下丅', '与丟丝万上专丛丅丌', '丟丆不万东丏丈丅七', '且丒不丝丘东丝丅业', '且丐丁丟丛与丛丙一', '且专丏丕丈万不万丛', 'InternalConstants', '万丅丅丕丆丆丐丞一', '丑丟丐丅一七丈丄丗', '丑丕且东七丐丞业丟', '丁丈丒丘与丙丛不丅', '东七丐丅下丆丑丈三', '上七丈丏三丝丏丆且', '世上丟丁丘丈丂七专', '且不丙丂丘丝不三丛', '丅丒业丐丄丂业三丏', '丈与业七不丛丕丈丙', '专三一丑丞一丂万丕', '不七东丝七丒丅上丘', '业丒专丒上七丂万丟', '丑下世丑丝丅东丑七', '业下丅丏丈丂上三丏', '一世丌丅丄世七丗下', '业业万丅丕丙东丁丗', '东丄丂专与丂丛丝丙', '丒丑与专丐丙丅丐世', '丅丂丙丐丑上东万万', '丘丕专丕与丁一丄丑', '丟丁与下丙丁丝丕丝', '丐上丙丙丌东丏丙世', '专不丗丞丗丆丐三东', '与丛丅丝丈丟丈丅与', '东丂一丏丏丕丛上东', '丂世丂丂丒下不丕丑', '丘丏丂丌丟不上丞丒', '三丈下专丌丟业一丈', '东丌丈丒丝丗丑丗丘', '一与丟世丂丂一七丂']
PlayerStats=['SR', 'RuntimeMarshal', 'RuntimeStructs', 'ASN1Convert', 'ReflectionExtensions', 'UnsafeNativeMethods', 'Win32Native', 'SpanHelpers', 'AppContextSwitches', 'LazyHelpers', 'DateTimeFormat', 'CompatibilitySwitches', 'ParseNumbers', 'ConsoleDriver', 'KnownTerminals', 'MonoCustomAttrs', 'ParameterizedStrings', 'StringBuilderCache', 'EncodingHelper', '__Error', 'FileSystemEnumerableFactory', 'FileSystemEnumerableHelpers', 'PathInternal', 'TimeSpanFormat', 'TimeSpanParse', 'EncodingTable', 'TextInfoToUpperData', 'TextInfoToLowerData', 'HashHelpers', 'PlatformHelper', 'TimeoutHelper', 'ThreadPoolGlobals', '_ThreadPoolWaitCallback', 'NativeEventCalls', 'AsyncCausalityTracer', 'TaskToApm', 'Constants', 'Utils', 'X509Helper', 'BinaryCompatibility', 'SerializationEventsCache', 'BinaryConverter', 'IOUtil', 'AsyncTaskCache', 'JitHelpers', 'Unsafe', 'HashHelpers', 'ReadOnlyDictionaryHelpers', 'IntrospectiveSortUtilities', 'SR', 'CertHelper', 'Debug', 'UnityTls', 'UnityTlsConversions', 'CFNetwork', 'MonoTlsProviderFactory', 'NoReflectionHelper', 'SystemCertificateValidator', 'CallbackHelpers', 'NativeMethods', 'SecurityUtils', 'IriHelper', 'UriHelper', 'IPv4AddressHelper', 'IPv6AddressHelper', 'LocalAppContextSwitches', 'IOSelector', 'Platform', 'TraceInternal', 'CompModSwitches', 'IntSecurity', 'CAPI', 'X509Helper2', 'HttpStatusDescription', 'NclUtilities', 'ValidationHelper', 'ExceptionHelper', 'WebExceptionMapping', 'TimerThread', 'UnsafeNclNativeMethods', 'Logging', 'EnumerableHelpers', 'SR', 'LocalAppContextSwitches', 'AsyncHelper', 'BinHexEncoder', 'Bits', 'BinaryCompatibility', 'Ref', 'ValidateNames', 'XmlComplianceUtil', 'Res', 'SR', 'Error', 'ArrayBuilderExtensions', 'ConstantCheck', 'Utils', 'ConvertHelper', 'DelegateHelpers', 'ScriptingRuntimeHelpers', 'ExceptionHelpers', 'CollectionExtensions', 'ContractUtils', 'ExpressionUtils', 'ExpressionVisitorUtils', 'TypeExtensions', 'EnumerableHelpers', 'BeforeRenderHelper', 'ClassLibraryInitializer', 'ManagedStreamHelpers', 'NetFxCoreExtensions', 'WebRequestUtils', 'SR', 'BigIntegerCalculator', 'BigNumber', 'NumericsHelpers', 'Internal_SubsystemInstances', 'Internal_SubsystemDescriptors', 'HashCodeHelper', 'SR', 'SQLResource', 'ADP', 'SqlConvert', 'Res', 'ActivePlatform', 'Native', 'PlatformInformation', 'Services', 'SR', 'SR', 'Utilities', 'SR', 'HashHelpers', 'RaycasterManager', 'Misc', 'SetPropertyUtility', 'ConvertUtils', 'DynamicUtils', 'EnumUtils', 'ImmutableCollectionsUtils', 'BufferUtils', 'JavaScriptUtils', 'JsonTokenUtils', 'MathUtils', 'MiscellaneousUtils', 'StringReferenceExtensions', 'StringUtils', 'TypeExtensions', 'ValidationUtils', 'SR', 'DecimalDecCalc', 'Number', 'SR', 'HashHelpers', 'ReadOnlySequence', 'ParserHelpers', 'ThrowHelper', 'ForegroundRealtimeClock', 'Utils', 'Constants', 'FacebookLogger', 'Utilities', 'FBUnityUtility', 'Utils', 'TweenWarning', 'Requires', 'Verify', 'BitOperations', 'MessagePackCompressionExtensions', 'SafeBitConverter', 'SequenceReaderExtensions', 'StreamPolyfillExtensions', 'StringEncoding', 'ThisLibraryExtensionTypeCodes', 'Utilities', 'UnityResolveryResolverGetFormatterHelper', 'UnityBlitResolverGetFormatterHelper', 'UnityBlitWithPrimitiveResolverGetFormatterHelper', 'DateTimeConstants', 'ExpressionUtility', 'FarmHash', 'ReflectionExtensions', 'BuiltinResolverGetFormatterHelper', 'DynamicGenericResolverGetFormatterHelper', 'NativeDateTimeResolverGetFormatterHelper', 'StandardResolverHelper', 'OakleyGroups', 'Version', 'PhotonCodes', 'SerializationProtocolFactory', 'EnumerableExtensions', 'DictionaryEntry', 'HashHelpers', 'TypeInfoExtensions', 'SR', 'StringEncoding', 'ZeroFormatterEqualityComparerHelper', 'LazyCollectionExtensions', 'KeyTuple', 'Extension_Methods', 'ScriptPrivateResource_Extension', 'WellKnownSymbols', 'LinqHelpers', 'LuaTypeExtensions', 'NamespaceDoc', 'CoreModules_ExtensionMethods', 'ModuleRegister', 'LexerUtils', 'Loader_Fast', 'ObjectValueConverter', 'SerializationExtensions', 'JsonTableConverter', 'NamespaceDoc', 'PlatformAutoDetector', 'NamespaceDoc', 'NamespaceDoc', 'NamespaceDoc', 'DescriptorHelpers', 'InteropRegistrationPolicy', 'NamespaceDoc', 'Tools', 'NamespaceDoc', 'TypeDescriptorRegistry', 'ClrToScriptConversions', 'NumericConversions', 'ScriptToClrConversions', 'StringConversions', 'TableConversions', 'MemberDescriptor', 'InstructionFieldUsage_Extensions', 'NamespaceDoc', 'NamespaceDoc', 'NamespaceDoc', 'Framework', 'MiniJsonExtensions', '丆丅丝不万丑丆丅东', '丐丗丕丌下丛丞上丈', '丆丆丘丝丕丞东丝丛', '丑丟丗丗丈且丑丏上', '丝丒丗丕丝丁丏且业', '丝丟丂下丌丈与丞一', '丄丂丂丘上丌丄不且', '丛丌丗丏丙且与丅丄', '万丆丗丘与丈世七丄', '丟东丕下三东万丏丌', '丂不丅且丒丅丂丁七', '丘丗东丅丝丒丘丗丒', '与且万丗万丟丂丌丁', '丗业丅上三丏专且下', '丐丞丅丒东丛七丟上', '丝东丅丙丛丁丙丒丝', '丅丒丒与丛丈一下丏', '丈下下丑丛丒且专丕', '三丒丞丕专业丟一丁', '丄丅丅万丝丕丕丗丁', '七丕丂丆与丐下丂丕', '七丄与世丄万丟丁丗', '三丘万且丐万三三丝', '丑丙丅下东丐丗且丝', '丒丞丗丅丝七丈丞丈', '三下丝丘丒丝丛三丌', '丞丆丗三丁丛与丙丏', '丕七丞丗丏丗不世世', '下下专业丌丆丈下不', '三一丞丁七与下一一', '丁下丑丙三丈丗丕上', '丙丟丑丁丞丗且丕丛', '东丄七专丟东业东丑', '丐丆丏丝丝丈丈丅丙', '东七业丗丒丕万丙丂', '丝丅专丁丝丞万丏丂', '丆与丅丏丒三不万丁', '丕三丝丄东丝丙万丝', '丕世与丑丟丗丝丗丕', '丞下丅丕世丘且丐丁', '上上东丝专七丗丆丕', '不专丙丕丛丑丞丄一', '不丒不丈丑丅丐丏丛', '丕丛丅丝下业七丑七', '丐七丘不丂丏丙丁不', '丂丈一三丒专三不丈', '不丈丅丐与丈业丐上', '丅业且丂丝上丘丑丘', '东一丘丝七不丈丘丐', '专丅且不丑丑丆丅且', '不下丏专丑丆三业丛', '不世丂与下丐丏丂专', '丝三丒不丁丕与丟丟', '丗丕丂专业与专与业', '丆下专一丕业丛万三', '丐下丟下丈东专丈丐', '一且丘丞一一丘丏七', '与丘丅丟丘不丘东三', '丏七业上丒丗丏丙七', '丘下且业业下丌丅丘', '丐丆丐丅丞丒七丝丌', '丌与丅东丁丗下丗丟', '万世丕丛丘丈业与不', '七上与三丘丘万丐丑', '丄丈不且丟专丞丟专', '与一丙丏丘下丞专丞', '丈且丟丘与丐与专丒', '丅丆丞丕一七丙丙丒', '专丙不丐七三一丅丆', '丙上丟丛丞丆丆丛丟', '下三丛丄万丁丌万业', '丑业丙东丕丕东万丂', '世丈丄丏丛丘七下上', '下丟丑与丅丂丘丏丁', '上下世一万丙丐万丏', '丕丙丝世下东且与万', '一专丏东丐丅丟下丅', '世专丕丙丒丘丕丟丂', '业丌丐丝丕丗丁丆丗', '丑丌七丌下丆三丑丈', '与丝丟七丒丁下下丝', '丕丄丕且下三丏万丞', '且一且与上丝丌丛且', '世丈丄丏丛丘七下上', '丏万且丌丛丄丁丟丁', '丄下东丘丒丐一上丟', '专丞丗万丙丞丗丗丂', '与丟丝万上专丛丅丌', '丄丘丙丐丝丆且丕一', '一丟丅丒与丈丝丕丁', '与三万丗业丙丆万丝', '丑上不与丐专东丟七', '专丅丆丟专丏与业丌', '丈丂不丁丑丒丁丏丈', '七丒东且丑丗丞丕且', '丑丞丄丏丈丂且丛与', '万一七丏不丄丛丘丑', '与三专丑三丅丑丗丂', '丗丁丞丈丏专丛七丂', '丛世丁丘丞丝与丞三', '丟丆不万东丏丈丅七', '丐丈一丏丘丘丕七丂', '东东丒丕丏丕丞丁丑', '且丒不丝丘东丝丅业', '业丑丞丄不丂丕丒与', '丅丌丏丒丕丈丞东丛', '万业东丐丑不丗丗丛', '上与万丟三丗丅丂一', '且丐丁丟丛与丛丙一', '专丐专丒且专下丄丗', '丆世业丞丁三下丆丐', '上丕丏丈丙丝且丝丒', '且专丏丕丈万不万丛', 'HTTPProtocolFactory', 'InternalInflateConstants', 'InternalConstants', '万丅丅丕丆丆丐丞一', '丑丟丐丅一七丈丄丗', '不丞丗与不丁万七丌', '丑丕且东七丐丞业丟', '丑丈丑丝上丗丕万丗', '丅七三丐丅丞丁东丕', '万丘丏丟丙东丛丘东', '丛丙一丟七业不丑不', '丁丈丒丘与丙丛不丅', '丝丙丞业三不业与丏', '专丂丆丈丙七丈丁丄', '丞东丅不且丑丝丅丆', '专不业东世一丕一三', '与丗丕丌丑业丌丄丏', '东丅丒丙丙三业丌丟', '丒且东丄丂丕且上七', '世七丟丐丂三丛丑与', '丐东丄丝丞七丞一不', '丐丑丅丄丟世丞丘业', '东七丐丅下丆丑丈三', '丛丑丗丗丁丙丄且丑', '丒东丝丕与丁不丅丒', '三下丗丕丝三丑上丌', '且丑与丞一丘丛与一', '不丘下丂不丄丟丄下', '上七丈丏三丝丏丆且', '万丑丄丛丛与业专丞', '世上丟丁丘丈丂七专', '且不丙丂丘丝不三丛', '丁丟丐与专专丛七丝', '丗丈下丏丂丑丟丏丁', '下且丟丆一七不丑与', '丅丅丏丟丘丞丟上万', '不东丂且世世且丈七', '丑不世东丝丗三丕三', '不下丐丝七丆专丙七', '丑东丑丐丄丐业业七', '下东业丒丄丝与丁万', '丝丏丄东且三三丆丕', '丙丑丌七丒丕丟丟丂', '七丑丘丁且业专下丐', '不丛丐丙一专上上丛', '三丛丞专丈丁丏丅丛', '一七丞与一丑丕一丈', '丐丑且丈丕丂丁丁丈', '丐丝一丙丆丟丁丑丐', '丂丛三不丕丕万丗丆', '丏丞丑丄丕丐丐丂一', '丑丟不三与丛一丌一', '丅丒业丐丄丂业三丏', '丝世丐丌丕丝丆专丗', '丛丆丁丙丗丆七丐丑', '丘一丙不业丏丂且丘', '且丈万世丒丙丛丞丙', '下丞且丞丕一丏专丗', '丗三丛东丘丐上丄丒', '与丝丞专下东丆丗丞', '业东七万丙三与万丘', '丈丝万丙上丄丟三丑', '丆一丒丆下丄丄丒丈', '与业丈丑万三丏丟业', '丅丆丐丟丟丞万丆世', '丈与业七不丛丕丈丙', '专三一丑丞一丂万丕', '丆丙丐七三丏丆三丘', '丒丈专下丕丈丁丘专', '丞丘丌上丝丅丞业七', '与丝七丒东丑丞丄丌', '七丌上丐丙丕丞丞不', '丆下丅丌上丁丐丕丌', '丂且丛丄世丅丄专业', '丞丙万丑丏丑丒丆一', '丛专丞丝丕业丒一与', '且丕丘万丑丟业丗万', '丝丛丕丑丙丄一世丟', '不七东丝七丒丅上丘', '专世丞丒世丂丘丙上', '丟丙丕丞丂三世丛丏', '丌且下丒丛丂丙丁东', '万丘丝丘与丟丄世丝', '三丘七丄一丗一丑丕', '业不且东丞丐与一丄', '丝下丑三丗一丏丐丒', '丞丆丄世世丑万丌丈', '丛七丙丒丐丄不东三', '专丑丂丌丙东丟丑丗', '世丈丂丗丄世丗丛上', '丙上丝且丄丝与丆专', '丙丗不丆一丆不东不', '业丒专丒上七丂万丟', '丑下世丑丝丅东丑七', '一专且丕世东丕东丑', '丟专丛丈丆丞丁丗万', '丗丞丑丑丐丑万丈丒', '丁丙下东上业且上专', '丆丂丅丈七丕丙丗且', '丙丅世一下丝世业下', '与丏丄专上丆丁一丈', '丒七丟不万一丅七丏', '丘丄丐丟不丌东世丝', '丙丌丈丌丒且丄业东', '业下丅丏丈丂上三丏', '万专且丌专且下丝丄', '丌万丌丅专丁丁业上', '丛下丂丒万专下万且', '业丈丂丁世七丗丈七', 'GuiStyle', '七丕丐上万丗丏业丅', '丆且且丝丆丄七上丈', '丞丁万丏丞丈世丌丛', '一丙丟丞丈且专万世', '一世丌丅丄世七丗下', '丕丆下与丂丝丏上丕', '丆丕万且丑世万世业', '丞丑丛丗世丑与一丂', '业业万丅丕丙东丁丗', '丁丌不上丗丕一丂丂', '东丄丂专与丂丛丝丙', '专丁丈丄丞丕丈丏丟', '世上丗丁丈下丈业丒', '且丂世丗丐丛丑不三', '丒丑与专丐丙丅丐世', '且万丌丙东万丌一专', '丕丈丒丕丐专丕业东', '丙丙丝丄丟与丗丐且', '丑丛丏一丆三丝上丝', '万丏丝丂下丒丏丘丏', '与丆丒丘丑业丈丞丐', '不且世七丞不丗丁且', '且三万丘业丗不不丒', '一丈万丅世东丒丄丞', '世三丕丄丆与丝丟丌', '且专一丟丑丐丏一丁', '丗业七丟与丛丅丑丘', '丗上丛丒上丆丙丛七', '丅丂丙丐丑上东万万', '丘丕专丕与丁一丄丑', '丙丞且丂丛丝世七丐', '东万丟丒丞丗丑丆丁', '丟丄丑且丅丄世与丗', '丟丁与下丙丁丝丕丝', '丐丅丛丅不丏七三丁', '丒与且丗丘上丗丈丌', '一丘丅与丐丏下丞丂', '丝不且且不下丅专一', '丐上丙丙丌东丏丙世', '专不丗丞丗丆丐三东', '丑丝下世丙丏丝业一', '丌丗世与丏业丝且丂', '丁丌与丐上丌上上丂', '丛丝专丌上丌丆丏丁', '世世三且三不东丝丄', '丙丘丞七丝一业丆丁', '丛东丙丆丄专丂上丈', '丆三专下丏专丑七业', '东丗丛丏丞丘丝丈一', '与丛丅丝丈丟丈丅与', '东丟丝三丞一丂丂丄', '东丂一丏丏丕丛上东', '丂世丂丂丒下不丕丑', '丒丛丈丛专丒丗与丂', '三三业万上丒丞且丌', '丄丆丗东丅丞丅东丝', '丘丏丂丌丟不上丞丒', '与丁丂丟丙上丕丂丐', '不丌下丛三丘丞丒丙', '丟三上丐丑丑丂丛丄', '丛丂一丈上丐丙丁丞', '三丈下专丌丟业一丈', '七不丕丌丑丙丘丐丕', '丐且万丟世丗丂丈丁', '丗与丄一丆丌东万丑', '丂丒与上万东丕专专', '丕三丅与丗丁专丑丝', '丂丙丏万一万丟丏丞', '东下业丙丅丁丒东丒', '丟丂丌丄丒万丒丒丟', '丕丈丙丙世专三且丙', '丂丞丑丌丘与万与且', '不专不三一万丌与业', '上业且丘丞丗下上丕', '世七丟不丒世丅丐丆', '东丌丈丒丝丗丑丗丘', '世丂丐丒丒与丆不丗', '丐东三丐丅不业丟丁', '业丘丞东丛丘丌丁三', '丗不丄丅丐专丒丆丙', '一丏丏丏丒专丙丅丐', '万丙丗丅不丐丅且丒', '一与丟世丂丂一七丂']
RealTimeEventListenerHelper=['HashHelpers']
RealTimeMultiplayerManager=['丑丙丅下东丐丗且丝', '东七业丗丒丕万丙丂', '丕世与丑丟丗丝丗丕', '丕丄丕且下三丏万丞', '上七丈丏三丝丏丆且', '丘丏丂丌丟不上丞丒']
RealTimeRoom=['HashHelpers']
RealTimeRoomConfig=['HashHelpers']
RealTimeRoomConfigBuilder=['HashHelpers', '丒丑与专丐丙丅丐世']
Score=[]
ScorePage=['丑丙丅下东丐丗且丝', '东七业丗丒丕万丙丂', '丕世与丑丟丗丝丗丕', '丘丏丂丌丟不上丞丒']
ScoreSummary=[]
Sentinels=[]
SnapshotManager=['DateTimeFormat', 'MonoCustomAttrs', 'Utils', 'Unsafe', 'HashHelpers', 'CFNetwork', 'TraceInternal', 'Utils', 'CollectionExtensions', 'ContractUtils', 'ExpressionUtils', 'BigIntegerCalculator', 'SQLResource', 'ADP', 'SqlConvert', 'PlatformInformation', 'SetPropertyUtility', 'ConvertUtils', 'DateTimeUtils', 'SR', 'Constants', 'Utilities', 'SequenceReaderExtensions', 'ExpressionUtility', 'FarmHash', 'ZeroFormatterSerializer', 'KeyTuple', 'PlatformAutoDetector', 'TypeDescriptorRegistry', '丐丗丕丌下丛丞上丈', '丄丂丂丘上丌丄不且', '三丘万且丐万三三丝', '丑丙丅下东丐丗且丝', '东七业丗丒丕万丙丂', '丕世与丑丟丗丝丗丕', '三丛与丈丆丄丄世一', '丝三丒不丁丕与丟丟', '与一丙丏丘下丞专丞', '丕丙丝世下东且与万', '丕丄丕且下三丏万丞', '专丅丆丟专丏与业丌', '万一七丏不丄丛丘丑', '万业东丐丑不丗丗丛', '且专丏丕丈万不万丛', '三丌丟世七丁丘丟一', '丝丕一丒上下不丅丕', '专不业东世一丕一三', '丛丑丗丗丁丙丄且丑', '上七丈丏三丝丏丆且', '七丑丘丁且业专下丐', '世丈丂丗丄世丗丛上', '丑下世丑丝丅东丑七', '丛下丂丒万专下万且', '且丂世丗丐丛丑不三', '且专一丟丑丐丏一丁', '丟丄丑且丅丄世与丗', '专不丗丞丗丆丐三东', '世世三且三不东丝丄', '与丛丅丝丈丟丈丅与', '丂世丂丂丒下不丕丑', '丘丏丂丌丟不上丞丒', '与丁丂丟丙上丕丂丐', '上业且丘丞丗下上丕']
SnapshotMetadata=['HashHelpers']
SnapshotMetadataChange=['HashHelpers']
SnapshotMetadataChangeBuilder=[]
StatsManager=[]
Status=[]
SymbolLocation=[]
TurnBasedMatch=['ConvertUtils', '丑丙丅下东丐丗且丝', '东七业丗丒丕万丙丂', '丕世与丑丟丗丝丗丕', '丕丄丕且下三丏万丞', '专丅丆丟专丏与业丌', '丝丕一丒上下不丅丕', '上七丈丏三丝丏丆且', '丛下丂丒万专下万且', '且专一丟丑丐丏一丁', '世世三且三不东丝丄', '丘丏丂丌丟不上丞丒']
TurnBasedMatchConfig=['HashHelpers']
TurnBasedMatchConfigBuilder=['HashHelpers', '丒丑与专丐丙丅丐世']
TurnBasedMultiplayerManager=['丑丙丅下东丐丗且丝', '东七业丗丒丕万丙丂', '丕世与丑丟丗丝丗丕', '三丛与丈丆丄丄世一', '丕丄丕且下三丏万丞', '丝丕一丒上下不丅丕', '上七丈丏三丝丏丆且', '丘丏丂丌丟不上丞丒']
Types=[]
VideoCapabilities=['ReflectionExtensions', 'SpanHelpers', 'KnownTerminals', 'AsyncCausalityTracer', 'NativeMethods', 'IPv4AddressHelper', 'ExceptionHelper', 'Error', 'TypeExtensions', 'Internal_SubsystemInstances', 'Internal_SubsystemDescriptors', 'DecimalDecCalc', 'ForegroundRealtimeClock', 'ReflectionExtensions', 'PhotonCodes', 'LazyCollectionExtensions', 'InteropRegistrationPolicy', 'MemberDescriptor', '丂不丅且丒丅丂丁七', '丘丗东丅丝丒丘丗丒', '丈下下丑丛丒且专丕', '七丄与世丄万丟丁丗', '业丌丐丝丕丗丁丆丗', '丐丈一丏丘丘丕七丂', '丐丑丅丄丟世丞丘业', '丙丑丌七丒丕丟丟丂', '丌万丌丅专丁丁业上', '丕丈丒丕丐专丕业东', '丌丗世与丏业丝且丂', '东下业丙丅丁丒东丒', '世七丟不丒世丅丐丆']
VideoCaptureState=['ReflectionExtensions', 'SpanHelpers', 'KnownTerminals', 'AsyncCausalityTracer', 'HashHelpers', 'NativeMethods', 'IPv4AddressHelper', 'ExceptionHelper', 'Error', 'TypeExtensions', 'Internal_SubsystemInstances', 'Internal_SubsystemDescriptors', 'DecimalDecCalc', 'ForegroundRealtimeClock', 'ReflectionExtensions', 'PhotonCodes', 'LazyCollectionExtensions', 'InteropRegistrationPolicy', 'MemberDescriptor', '丂不丅且丒丅丂丁七', '丘丗东丅丝丒丘丗丒', '丈下下丑丛丒且专丕', '七丄与世丄万丟丁丗', '业丌丐丝丕丗丁丆丗', '丐丈一丏丘丘丕七丂', '丐丑丅丄丟世丞丘业', '丙丑丌七丒丕丟丟丂', '丌万丌丅专丁丁业上', '丒丑与专丐丙丅丐世', '丕丈丒丕丐专丕业东', '丌丗世与丏业丝且丂', '东下业丙丅丁丒东丒', '世七丟不丒世丅丐丆']
VideoManager=['HashHelpers', '丘丏丂丌丟不上丞丒']
Logger=['Logger']
Misc=['MemoryExtensions']
PlatformUtils=['PlatformUtils']
Achievement=['Achievement']
CommonTypesUtil=['CommonTypesUtil']
LeaderboardScoreData=['LeaderboardScoreData']
PlayerStats=['PlayerStats']
ScorePageToken=['ScorePageToken']
VideoCapabilities=['VideoCapabilities']
VideoCaptureState=['VideoCaptureState']
Invitation=['Invitation']
MatchOutcome=['MatchOutcome']
TurnBasedMatch=['TurnBasedMatch']
GoogleMobileAdsClientFactory=[]
AppLovinClientFactory=['丅丈世不一世丏丄丝']
TapjoyClientFactory=['丅丈世不一世丏丄丝']
UnityAdsClientFactory=['丅丈世不一世丏丄丝']
Utils=['TableModule_Globals']
Utils=['DynamicModule', 'LoadModule', 'Quads']
AdapterStatus=['万东东世丙丌丏丟七', 'Invitation', 'LobbyItemsBundle']
AdLoader=['EventDelegate', '与丘丐丒丛丅丕丈丆', 'LobbyItemsBundle']
AdRequest=['XmlSchemaSet', 'MessagePackSerializerOptions', '与丘丐丒丛丅丕丈丆']
AdSize=['IPAddress', 'MessagePackSecurity', '丝业丅丑业丝东业世']
BannerView=['丈与专丒丆丕丞专丏']
CustomNativeTemplateAd=[]
InterstitialAd=['丈与专丒丆丕丞专丏']
MobileAds=['丘且一丟丒丞东丘下']
RewardBasedVideoAd=['GUIStyle', '丈与专丒丆丕丞专丏']
RewardedAd=['丈与专丒丆丕丞专丏']
MediationExtras=['IPGlobalProperties']
UnityAds=['丌三丙丝丑丕与上丌']
Tapjoy=['GoogleIAB', 'TwitterAndroid', '丌三丙丝丑丕与上丌', '不东且丙世万丟东丞', '丘且一丟丒丞东丘下', '丟一丕丑丟丈丝一丈']
AppLovin=['丘且一丟丒丞东丘下']
BuildSettings=['专丞丗万丙丞丗丗丂']
DigestStorager=['丙且丒丁丐三不丙丞']
DirectionViewerSettings=['DirectionViewerSettings']
ResourceProfiler=['专世不丌不万一东丆']
MaterialInfo=[]
MeshInfo=[]
SaltedFloatEps=['丘丝丙丈丂与丐丟下']
SaltedFloatNew=['业一七丕下专与丏丏']
AchievementData=['与丘丐丒丛丅丕丈丆']
AchievementProgress=['七丆且上丑丛丗丗丏']
AchievementProgressData=['AchievementProgressData']
AchievementProgressSyncObject=['AchievementProgressSyncObject']
Awaiter=['GUIStyleState']
AdPointsConfigMemento=['GUIStyle', 'JsonProperty']
AdPointMementoBase=['AsyncProtocolRequest']
AdsConfigManager=['丞丝下三下丂丁业一']
AdsConfigMemento=['HttpConnection', 'GUIStyle', '与丑万业东下丗上丂']
CheaterConfigMemento=['丂丕丕一丝丗专丌一']
PlayerStateMemento=['HttpConnection']
FakeInterstitialConfigMemento=['Index']
InterstitialConfigMemento=['LabelInfo', '丁丙丏与丞丈丐一丈', '丕专丄丈七丘丙丈丘', '丝三丑业东丈丞丟丝', '业东专丌丅丁丄专东']
InterstitialOverrideMemento=['HttpConnection']
InterstitialCounter=['丂丕丕一丝丗专丌一']
ParsingHelper=['上丙丁丙丟一一丑专']
PerelivConfigManager=['丙丞丂丁下丌下丈丗']
PerelivSettings=['三下丝丑丞丕丕丅下']
VideoConfigMemento=['XPathScanner', 'LabelInfo', '丄一一丌东丅丘一丗']
AnalyticsConstants=['丗丐不世丙丗丄丗丟']
AnalyticsFacade=['丈丌业丌丁丅下丆丘']
AnalyticsLegacy=['HttpListenerRequestUriBuilder', '万丒丏丆万不七丒丞']
AnalyticsStuff=['丅丝丂东世且丁丕丟']
AppsFlyerFacade=['丑丐与业丗专丈丂业']
DevToDevFacade=['丟东丕丌不且七丘丗']
FacebookFacade=['丘丆丗专丌丐一丕上']
FlurryFacade=['丑与丅丆万丝丂丛七']
ParametersCache=['丄丘丙丐丝丆且丕一']
AndroidSystem=['世丅丌专丐上专丄下']
FogSettings=['FogSettings']
SkySettings=['SkySettings']
PlayerStepsSoundsData=['PlayerStepsSoundsData']
AutomaticBannerViewManager=['丆丕丑丟丝丄丕丘上']
BattleInviteListener=['丒丆丁丟且丅丒丈上']
CharactersManagementRecommender=['与三万丗业丙丆万丝']
ClanChestDropRules=['丗东且丗七丕丘丐丂']
ClansRecommender=['丑上不与丐专东丟七']
CloudApplyer=['丛万七业不万下丙丒']
CloudSlotSynchronizerFactory=['专丅丆丟专丏与业丌']
CloudSyncController=['一丟且丏世丈丘丐丙']
CloudSynchronizationConstants=['丄丂丂丘上丌丄不且', '专丅且不丑丑丆丅且']
IcloudService=['七丒东且丑丗丞丕且']
MetadataExtensions=[]
CloudSlotSynchronizer=['丑上且丟丘丑丁丙丄']
GooglePullHelper=['丁丙丏与丞丈丐一丈']
GooglePushHelper=['丕专丄丈七丘丙丈丘']
CloudMigrationGenerationInfo=[]
ProgressHashCloudVersionData=['且丘丞丛且上七丏万']
UsedMigrationHashCloudVersionData=['丟下丁丅丁与且专不']
TechnicalCloudInfo=['TechnicalCloudInfo']
WeaponCraftDetailsInfo=['万一七丏不丄丛丘丑']
AesFacade=['不三丙丈丈丟专下世', '不不东世万一上丛东', '丂丕丐丐丄丙丙丂不', '丏三丂与丂下与丁丞']
CryptoPlayerPrefsFacade=['东丒丏万丛丒专三东']
EncryptedPlayerPrefs=['丙下丟丗丗丈丄丁丌']
DevChangerPlayerData=['丂丒七不丘丘不丑丄']
MemoryLimit=[]
DoubleReward=['丐业业三丙丞丝丑丈']
DuelsRecommender=['丗丁丞丈丏专丛七丂']
Egg=['东丝东且丑且丆丟丆', '与丘丐丒丛丅丕丈丆', '丙七丌万三丑下下且']
EggsAndPetsConfigManager_V2=['丂丞万丅丄业丁丄不']
EggsAndPetsDropContainer=[]
EggDrop=['EggDrop']
PetDrop=['PetDrop']
EggData=['PlaceableItemSettings', 'AlternativeAttackSettings', 'EggData', '下丕业与丘三丌丙且']
EggPetInfo=[]
PlayerEggs=['PlayerEggs']
EggIncubatorProgress=['EggIncubatorProgress']
FortItemState=['FortItemState']
FortItemGroup=['丕丅丞世丝丁丆丄丅']
FortItemPlayerInfo=['FortItemPlayerInfo']
FortItemPlayerLockerInfo=[]
FortItemPlayerInfoSerializedObject=[]
GameCurrencyData=['GameCurrencyData']
GameEventsDataContainer=[]
GameEventData=['GameEventData']
GameEventChestData=['GameEventChestData']
GameEventChestPriceContainer=['GameEventChestPriceContainer']
GameEventChestPartsPriceContainer=['GameEventChestPartsPriceContainer']
GameEventItemContainerData=['GameEventItemContainerData']
DroppedItemDataContainer=[]
DroppedItemData=['DroppedItemData']
GameEventRewardData=['GameEventRewardData']
GameEventBuyCurrencyWindow=['丟一丕丑丟丈丝一丈']
GameEventChest=['与丑万业东下丗上丂']
GameEventItem=['GameEventItem']
GameEventItemContainer=['GameEventItemContainer']
GameEventsController=['丂丆丄东丌世且世丁']
GameEventsDropHistoryManager=['丙丐世丛丛东专丄丄']
GMEParser=['业丂且丆下丞丛丁丙']
GameModeLocker=['东丁丈丙丛丝丘下上']
GpgFacade=['丞丝下三下丂丁业一']
BonusData=['BonusData']
CustomBonusProvider=['不丛丟世丞世丒上丕']
InterstitialManager=['东丁丈丙丛丝丘下上']
LeaderboardsMiniGameDataManager=['丘丈丒丁丈与下七一']
LiderboardsMinigamesDataHandler=[]
LiderboardsMinigamesGameModeData=['LiderboardsMinigamesGameModeData']
LeaderboardsMiniGameDataRow=['LeaderboardsMiniGameDataRow']
LoadingProgress=['丏三丂与丂下与丁丞']
LoadingTip=['专三丗万丑丛上丏丝']
LoadingTipExtension=[]
LobbyBundlesRecommender=['丌世一丈丅丄丅丆丑']
BackgroundsManager=['丆丗三不上不丞丛丐']
LobbyBundleReward=['LobbyBundleReward']
LobbyBundleRewardData=['LobbyBundleRewardData']
LobbyItemPlayerLockerInfo=[]
LobbyItemPlayerInfoSerializedObject=[]
LobbyItemPlayerInfoParser=['丟丆不万东丏丈丅七']
LobbyItemPlayerLockerInfoParser=['丐丈一丏丘丘丕七丂']
LobbyItemsBundle=['LobbyItemsBundle']
LobbyItemGroup=['丟万丘专丟专丄丗丞']
LocalNotificationConfig=['丈丏一专不七与万专']
LogsManager=['且丒不丝丘东丝丅业']
MarketProductFactory=[]
MiniGamesPlayerScoreManager=['丒下丅丌丐与丝丛丄']
OfferItemCacheIds=['专与丌七丛丟三丝业']
OfferItemHelper=['万业东丐丑不丗丗丛']
OfferItemId=['丞专丞丂丈七丕专三', '丆丕一专且丐业三丒']
OfferPlayerData=['LTRect', 'GameEventChestData', 'BonusData']
OfferPlayerDataContainer=[]
OfferPlayerDataConditionProgress=['ObjectRef']
OffersController=['丂丆丄东丌世且世丁']
ContextsData=['FortItemState']
PersConfiguratorWeaponChooser=['上与万丟三丗丅丂一']
PersistentCache=['三下丂丞丙丆专一一']
PetAnimation=['PetAnimation']
PetUpdateInfo=['ObjectHolder', '丏丗且世丏三三丝专']
PlayerPets=['ServicePoint', 'AchievementProgressSyncObject']
VTable=['专业丟不万世丂不三']
PrefabHandler=['PrefabHandler']
QuestBase=['丆专丒丆丘业不万业']
QuestConstants=['且丐丁丟丛与丛丙一']
QuestInfo=['专丏丙且世不丅世丅']
QuestMediator=['丒三丝丑丗业丙丗丗']
QuestEvents=['丞东上丕上业丁丗丂']
MiniGameRatingDownloader=['与丐一丁丌丘世七丂']
Tools=['上丙丁丙丟一一丑专']
MailUrlBuilder=['丕三丝与业丁丄丛丙']
ExistsSceneInfo=[]
ScreenshotManager=['丅丈世不一世丏丄丝']
ServiceLocator=[]
ItemCraftConfig=['丙丝丝丞上与丙万丗']
Statistics=[]
RentChestData=['RentChestData']
WearParser=['与不东丈下丕丟丌丗']
WWWLogger=['东世丄三丝下与丝丑']
LimitsController=['丙一丗丗业丁丅丙且']
ProgressBounds=['丕丂一丂丅丈丑丈上']
TimeMeasurement=['不丒丒丑丁与下丁与']
WeaponSkin=['WeaponSkin']
WeaponSkinsManager=['丅丒且专丁与丄丑丄']
WeaponSkinTexture=['WeaponSkinTexture']
EventsTimeoutController=['丞丈上丅世且丝专丛']
ServerEventNames=[]
WebSocketCallbacks=['一丟世不东且丁丒丞']
PushNotificationData=['丁丈丟不东万业专下']
AbstractContentGenerator=['丌丏三七七丟下丅七']
AdaptiveSettings=['丈专丛业丑丈七业一']
AdaptiveOffersDebug=['丆世业丞丁三下丆丐']
ModulesOffersCfg=[]
OfferModuleUtility=['AsyncTaskCache', '万丆丗丘与丈世七丄', '且专丏丕丈万不万丛', '世七下且丕丞业丞三']
OfferHelpers=[]
AbstractContextOfferInjector=['世丐与丂丗丙丘丞丆']
NullEx=[]
Json=[]
PemParser=['丂丕丆丞丛丌万丕丒']
X509CertificateParser=['XmlReflectionImporter']
X509CrlParser=['XmlReflectionImporter']
X509SignatureUtilities=['X509Utilities']
X509ExtensionUtilities=[]
Arrays=['Arrays']
BigIntegers=['BigIntegers']
Enums=['Enums']
Integers=['Integers']
Platform=['Platform']
Strings=['Strings']
Times=['Times']
Adler32=['Adler32']
Deflate=['Deflate']
InfBlocks=['InfBlocks']
InfCodes=['InfCodes']
Inflate=['Inflate']
InfTree=['InfTree']
JZlib=['JZlib']
StaticTree=['StaticTree']
ZStream=['ZStream']
ZTree=['ZTree']
IPAddress=['IPAddress']
Streams=['Streams']
PemHeader=['PemHeader']
PemReader=['PemReader']
PemWriter=['PemWriter']
Base64=['Base64']
Hex=['Hex']
DateTimeObject=['DateTimeObject']
DateTimeUtilities=['DateTimeUtilities']
CollectionUtilities=['CollectionUtilities']
DigestUtilities=['DigestUtilities']
MacUtilities=['MacUtilities']
PublicKeyFactory=['PublicKeyFactory']
SignerUtilities=['SignerUtilities']
BigInteger=['BigInteger']
Interleave=['Interleave']
Mod=['Mod']
Nat=['Nat']
Nat128=['Nat128']
Nat160=['Nat160']
Nat192=['Nat192']
Nat224=['Nat224']
Nat256=['Nat256']
Nat320=[]
Nat384=[]
Nat448=[]
Nat512=[]
Nat576=[]
FiniteFields=['FiniteFields']
ECAlgorithms=['ECAlgorithms']
ECCurve=['ECCurve']
ECFieldElement=['ECFieldElement']
ECPoint=['ECPoint']
LongArray=['LongArray']
FixedPointUtilities=['FixedPointUtilities']
WNafUtilities=['WNafUtilities']
GlvTypeBParameters=['GlvTypeBParameters']
SecP128R1Field=[]
SecP160R1Field=[]
SecP160R2Field=[]
SecP192K1Field=[]
SecP192R1Field=[]
SecP224K1Field=[]
SecP224R1Field=[]
SecP256K1Field=[]
SecP256R1Field=['SecP256R1Field']
SecP384R1Field=['SecP384R1Field']
SecP521R1Field=['SecP521R1Field']
SecT113Field=['SecT113Field']
SecT131Field=[]
SecT163Field=[]
SecT193Field=[]
SecT233Field=[]
SecT239Field=[]
SecT283Field=['SecT283Field']
SecT409Field=[]
SecT571Field=['SecT571Field']
Curve25519Field=['Curve25519Field']
SimpleBigDecimal=['SimpleBigDecimal']
Tnaf=['Tnaf']
ZTauElement=['ZTauElement']
AsymmetricCipherKeyPair=['AsymmetricCipherKeyPair']
Check=['Check']
CipherKeyGenerator=['CipherKeyGenerator']
KeyGenerationParameters=['KeyGenerationParameters']
PbeParametersGenerator=['PbeParametersGenerator']
Pack=['Pack']
AlertDescription=[]
AlertLevel=[]
ByteQueue=['ByteQueue']
CertChainType=[]
Certificate=['Certificate']
CertificateRequest=['CertificateRequest']
CertificateStatus=[]
CertificateStatusRequest=[]
CertificateStatusType=[]
ChangeCipherSpec=[]
CipherSuite=[]
CipherType=[]
ClientCertificateType=[]
CompressionMethod=[]
ConnectionEnd=[]
ContentType=[]
DigitallySigned=['DigitallySigned']
ECBasisType=[]
ECCurveType=[]
ECPointFormat=[]
EncryptionAlgorithm=[]
ExporterLabel=['ExporterLabel']
ExtensionType=['ExtensionType']
FiniteFieldDheGroup=[]
HandshakeType=[]
HashAlgorithm=['HashAlgorithm']
HeartbeatExtension=['HeartbeatExtension']
HeartbeatMessageType=[]
HeartbeatMode=[]
KeyExchangeAlgorithm=[]
MacAlgorithm=[]
MaxFragmentLength=[]
NamedCurve=['NamedCurve']
NameType=[]
NewSessionTicket=['NewSessionTicket']
OcspStatusRequest=['OcspStatusRequest']
PrfAlgorithm=[]
ProtocolVersion=['ProtocolVersion']
RecordStream=['RecordStream']
SecurityParameters=['SecurityParameters']
ServerDHParams=['ServerDHParams']
ServerName=['ServerName']
ServerNameList=['ServerNameList']
SessionParameters=['SessionParameters']
SignatureAlgorithm=[]
SignatureAndHashAlgorithm=['SignatureAndHashAlgorithm']
SupplementalDataEntry=['SupplementalDataEntry']
TlsDHUtilities=['TlsDHUtilities']
TlsEccUtilities=['TlsEccUtilities']
TlsExtensionsUtilities=['TlsExtensionsUtilities']
TlsMac=['TlsMac']
TlsProtocol=['TlsProtocol']
TlsRsaUtilities=['TlsRsaUtilities']
TlsUtilities=['TlsUtilities']
IsoTrailers=['IsoTrailers']
DHValidationParameters=['DHValidationParameters']
DsaValidationParameters=['DsaValidationParameters']
ECDomainParameters=['ECDomainParameters']
Gost3410ValidationParameters=['Gost3410ValidationParameters']
X509Utilities=['X509Utilities']
GcmUtilities=['GcmUtilities']
DHKeyGeneratorHelper=['DHKeyGeneratorHelper']
DHParametersHelper=['DHParametersHelper']
IesEngine=['IesEngine']
RsaCoreEngine=['RsaCoreEngine']
CustomNamedCurves=['CustomNamedCurves']
Asn1Generator=['Asn1Generator']
Asn1StreamParser=['Asn1StreamParser']
Asn1Tags=[]
OidTokenizer=['OidTokenizer']
ECNamedCurveTable=['ECNamedCurveTable']
X962NamedCurves=['X962NamedCurves']
X9ECParametersHolder=['X9ECParametersHolder']
X9IntegerConverter=['X9IntegerConverter']
X9ObjectIdentifiers=['X9ObjectIdentifiers']
X509Extension=['X509Extension']
X509NameEntryConverter=['X509NameEntryConverter']
X509NameTokenizer=['X509NameTokenizer']
X509ObjectIdentifiers=['X509ObjectIdentifiers']
Asn1Dump=['Asn1Dump']
TeleTrusTNamedCurves=['TeleTrusTNamedCurves']
TeleTrusTObjectIdentifiers=['TeleTrusTObjectIdentifiers']
SecNamedCurves=['SecNamedCurves']
SecObjectIdentifiers=['SecObjectIdentifiers']
PkcsObjectIdentifiers=['PkcsObjectIdentifiers']
OiwObjectIdentifiers=['OiwObjectIdentifiers']
NistNamedCurves=['NistNamedCurves']
NistObjectIdentifiers=['NistObjectIdentifiers']
MiscObjectIdentifiers=['MiscObjectIdentifiers']
IanaObjectIdentifiers=['IanaObjectIdentifiers']
CryptoProObjectIdentifiers=['CryptoProObjectIdentifiers']
ECGost3410NamedCurves=['ECGost3410NamedCurves']
Gost3410NamedParameters=['Gost3410NamedParameters']
AnssiNamedCurves=['AnssiNamedCurves']
AnssiObjectIdentifiers=['AnssiObjectIdentifiers']
KeepAliveHeader=['KeepAliveHeader']
HTTPManager=['HTTPManager']
HTTPProtocolFactory=['HTTPProtocolFactory']
HTTPProxy=['HTTPProxy']
HTTPRange=['HTTPRange']
WebSocket=['WebSocket']
WebSocketFrame=['WebSocketFrame']
WebSocketFrameReader=['WebSocketFrameReader']
Error=['Error']
HandshakeData=['HandshakeData']
Packet=['Packet']
SocketOptions=['SocketOptions']
EventDescriptor=['EventDescriptor']
EventNames=['EventNames']
EventTable=['EventTable']
Subscription=['丒一下丌丐丝下丒七']
HubOptions=['HTTPProxy']
HubConnection=['GUIStyle']
Message=[]
SupportedTransport=['HandshakeData']
NegotiationResult=['HandshakeData', 'Packet', 'Digest']
NegotiationData=['与丘丐丒丛丅丕丈丆', 'Packet']
TransportBase=['与丑万业东下丗上丂']
Message=['Message']
Json=['Json']
HTTPFieldData=['HTTPFieldData']
HTTPFormBase=['HTTPFormBase']
Extensions=['Extensions']
ExceptionHelper=[]
HeaderValue=['HeaderValue']
HeartbeatManager=['HeartbeatManager']
KeyValuePairList=['KeyValuePairList']
DeflateManager=['DeflateManager']
InflateBlocks=['InflateBlocks']
InternalInflateConstants=['InternalInflateConstants']
InflateCodes=['InflateCodes']
InflateManager=['InflateManager']
InfTree=['InfTree']
SharedUtils=['SharedUtils']
InternalConstants=['InternalConstants']
StaticTree=['StaticTree']
Adler=['Adler']
ZlibCodec=['ZlibCodec']
ZlibConstants=[]
ZTree=['ZTree']
CRC32=['CRC32']
CookieJar=['CookieJar']
HTTPCacheFileLock=['HTTPCacheFileLock']
HTTPCacheMaintananceParams=['HTTPCacheMaintananceParams']
HTTPCacheService=['HTTPCacheService']
Credentials=['Credentials']
Digest=['Digest']
DigestStore=['DigestStore']
AlmanachDataContainer=[]
IngameGuiVisibility=['丅丛丙丒丞丘丒三丆']
AdConstants=[]
InterstitialSuppressor=[]
TrygunAdController=['七丆丕三丁丅丗且下']
AttributionConstants=[]
AttributionManager=['丄一一丌东丅丘一丗']
UserIdHelper=[]
BatteryManager=[]
ConfigPaths=[]
ConfigSystem=['丄丙一丒上丝不丗与']
ConvertHelper=[]
CoroutineHelper=[]
CollectionExtensions=['TableConversions', '与丟丝万上专丛丅丌']
GameConditionAbstract=['上丝丝一上丝万业业']
GameConditionFactory=[]
GameConditionSettings=[]
PersistentDataManager=['丏丒丟与且丕业丘丄']
GamePlaceManager=['丝世丐丌丕丝丆专丗']
GameRewardsController=['世七丂上丗丞丁丂上', '专丐万丙一丐丟上丆']
GameTask=['七丕一丐且丗丅不丙']
GameTaskActionAbstract=['万丁丂丆七丙丈丆下']
GameTaskActionFactory=[]
GameTaskActionSettings=['七上丕下不丟下丁丟']
GameTaskConfig=['与丛不三丞丝世下丛']
GameTaskProgressAbstract=['丑专丁三丛丙且三下']
GameTaskProgressFactory=[]
GameTaskSlotProgress=['丗业万不上且不丈且']
BankCellColorsSetterData=[]
Product=['丁丂丄下丄丌丞丟丙']
ProductsHelper=['业丂丁丑万丘业丟专']
ItemConverterId=['专丈丗丟丂丐三丄丞']
ItemsDB=[]
ItemBase=['丅丏丌丏丐且丒专业', '丏丕丌丕东丏一业一', '丌丝丞下丕与丟东下', '上东丙丕万丝丗丗不', '万丞丕丝丛下上丝丘']
ItemClientId=['且业丗万丗丛丛丙丌']
ItemFactory=['丈丝万丙上丄丟三丑']
ItemHelper=['丒且丂丄万丛丟丕丈', '一丗丕丞丝不丏三一']
ItemManager=['丄且下丝丑三丛丛丞', '业三且丝东丝东与丕']
ItemParams=['上东丙丕万丝丗丗不']
ItemProviderAbstract=['丟丘丅专丝丑丟丁且']
ItemTransactionActionAbstract=[]
LobbyTransitionAbstract=['丕丈丄丅且丄丐丕丝']
LobbyTransitionFactory=[]
LobbyTransitionHelper=[]
LobbyTransitionSettings=['七上丕下不丟下丁丟', '丂业丞丛丛丅丄且丏', '七丒丒丅下丘且丈万']
ModuleConsts=[]
ModulesContainer=[]
CommonModulesSettings=[]
ModuleExtensions=[]
ModulesAdder=['丁丄东丝专丒丕丛丙']
ModulesController=['丒丞且丕丙且丌三丗']
ModulesGenerationHelper=[]
ModulesHelper=[]
ModulesInfo=['丐丑与且丏不东丁丘']
ModuleStorage=['万丟丝与丛一且丐东']
ModuleStorageData=[]
NetworkReachability=['丐上丙且丗下七丆万']
DailyTierOffersConfig=['不不上专丌与专丟世']
DailyTierOffersExtention=['上丕丏丈丙丝且丝丒']
DailyTierOffersProgress=['东丄业世丟丞丈丆丝']
LegacyOffersModuleHelper=[]
PurchaseStatistics=['万丅丛下东万丈东丄']
ItemsPurchasesContainer=[]
ItemsPurchase=['ItemsPurchase']
RomanNum=['丙上丝且丄丝与丆专']
SpeedupHelper=['一专且丕世东丕东丑']
TaskBookConfig=[]
TaskBookHelper=['万专且丌专且下丝丄']
GuiStyle=[]
ListPoolExtensions=['AsyncTaskCache', 'JitHelpers', 'EnumerableHelpers', 'TableConversions', '与丟丝万上专丛丅丌', '专三一丑丞一丂万丕']
WeaponDexController=['丛下专不业东不丐上']
StringBuilderCache=['丕丆下与丂丝丏上丕']
GMEController=['丒丞且丕丙且丌三丗']
GMEEvent=['万丟丝与丛一且丐东']
GMEModificator=['丗一丅丌业丗丟丟与']
GMERewardHelper=['丛丘丘上丈丒丂丆三']
GMERewardModificator=['丌丌三三丛丄丑且业']
BattlePass=['丙七丌万三丑下下且']
BPChallenge=['下丕业与丘三丌丙且']
BPChallangesProgressForSeason=['BPChallangesProgressForSeason']
BPChallangesProgressAllSeasons=[]
BPChallengeParameter=['BPChallengeParameter']
BPChallengeRememberedRewardsList=[]
BPChallengeRememberedReward=['BPChallengeRememberedReward']
BPChallangeDOList=[]
BPData=['BPData']
BPParseConfigOldFormat=['一丈万丅世东丒丄丞']
BPResourceManager=['三丌东丅丗丐丞丐丆']
BPSlotProgress=['丘丏丁丗丆丂丙丅丞']
BPSlotProgressMigrate=['世三丕丄丆与丝丟丌']
BPSlotProgressParser=['且专一丟丑丐丏一丁']
BPSlotStringForHashGenerator=['丗业七丟与丛丅丑丘']
BPTransitionAbstract=['丁万丆丈三丟丐业三']
BPTransitionFactory=['丁业丏丄丂丅丙与业']
BPTransitionManager=['丗上丛丒上丆丙丛七']
BPChallengeCondition=['丗丁丙与东丝丑且世']
BPDataContainer=[]
BPDataContainerList=[]
BattlePassHelper=['丅丂丙丐丑上东万万']
BattlePassReminderGiveRewards=['丘丕专丕与丁一丄丑']
BPPhrase=['BPPhrase']
BPPhraseConditionAbstract=[]
BPPhraseConditionFactory=[]
AbstractGameplayLoop=['丏丕丌丕东丏一业一', '丘丁一下一丗万丞且']
GameplayLoopsManager=[]
FirebaseAnalyticsFacade=['与丌丕丌丆丛丘丕世']
FirebaseAnalyticsHelper=[]
InhouseAnalytics=['世一七上丟一丑东丘']
InhouseAnalyticsExtensions=['丙丞业丘世丝丏世丂', '丟丗下上上丙世丑万', '丂万丅丂且不世业丂']
MessageConstants=['且专一丟丑丐丏一丁']
MessageNameIds=[]
AdMobFacade=['丈丏一专不七与万专']
AdMobHelper=['丟丁与下丙丁丝丕丝']
AdMobPrefetcher=['丘万丁万丑不丂丆丌', '七丆丕三丁丅丗且下', '丝三丑业东丈丞丟丝', '业东专丌丅丁丄专东']
AdMobTest=['丕丟七专丞丑丛丂万']
AdMobUnitIds=['上丏丄丐专丘丌丟丝']
AdPointConstants=[]
FyberHelper=['EncodingHelper', 'MonoTlsProviderFactory', '丈下下丑丛丒且专丕', '丄丅丅万丝丕丕丗丁', '七丕丂丆与丐下丂丕', '上下世一万丙丐万丏']
InterstitialAdPromise=['不丁丝三上丟丑丐不']
MoPubUnitIds=['万专丐丁丞丈业与丌']
RewardedAdPromise=['不丁丝三上丟丑丐不']
OfferwallPlacementPrefetcher=['业东专丌丅丁丄专东']
OfferwallPlacementPromise=['丏上下丐丂丕丒丈丗', '上七丘业七丝丝七东', '丏丗且世丏三三丝专', '万丟丝与丛一且丐东', '丛丈与丂丈丐七上丐', '不丁丝三上丟丑丐不']
TapjoyConstants=[]
TapjoyFacade=['丕丟七专丞丑丛丂万', '丁丞东丗丁丂上丟丟', '丏业丂三业丐丘丕一', '丟丏丞丒丆丈丐东丞']
